seqname	sample	bp	cov	del	ins	indel	delRatio	insRatio	indelRatio	ReadNoDel	NoDelRatio
pcrVenus	VenusDel	1	5615	0	0	0	0	0	0	5615	1
pcrVenus	VenusDel	2	5724	0	0	0	0	0	0	5724	1
pcrVenus	VenusDel	3	5741	9	2	11	0.0015676711	0.0003483714	0.0019160425	5732	0.9984323289
pcrVenus	VenusDel	4	5749	2	1	3	0.0003478866	0.0001739433	0.0005218299	5747	0.9996521134
pcrVenus	VenusDel	5	5750	2	4	6	0.0003478261	0.0006956522	0.0010434783	5748	0.9996521739
pcrVenus	VenusDel	6	5752	0	1	1	0	0.0001738526	0.0001738526	5752	1
pcrVenus	VenusDel	7	5752	0	0	0	0	0	0	5752	1
pcrVenus	VenusDel	8	5752	0	0	0	0	0	0	5752	1
pcrVenus	VenusDel	9	5752	0	1	1	0	0.0001738526	0.0001738526	5752	1
pcrVenus	VenusDel	10	5752	0	0	0	0	0	0	5752	1
pcrVenus	VenusDel	11	5752	0	0	0	0	0	0	5752	1
pcrVenus	VenusDel	12	5752	0	1	1	0	0.0001738526	0.0001738526	5752	1
pcrVenus	VenusDel	13	5752	0	3	3	0	0.0005215577	0.0005215577	5752	1
pcrVenus	VenusDel	14	5752	2	5	7	0.0003477051	0.0008692629	0.001216968	5750	0.9996522949
pcrVenus	VenusDel	15	5752	0	0	0	0	0	0	5752	1
pcrVenus	VenusDel	16	5752	1	3	4	0.0001738526	0.0005215577	0.0006954103	5751	0.9998261474
pcrVenus	VenusDel	17	5752	0	0	0	0	0	0	5752	1
pcrVenus	VenusDel	18	5752	1	11	12	0.0001738526	0.0019123783	0.0020862309	5751	0.9998261474
pcrVenus	VenusDel	19	5752	1	15	16	0.0001738526	0.0026077886	0.0027816412	5751	0.9998261474
pcrVenus	VenusDel	20	5752	10	4	14	0.0017385257	0.0006954103	0.002433936	5742	0.9982614743
pcrVenus	VenusDel	21	5752	1	1	2	0.0001738526	0.0001738526	0.0003477051	5751	0.9998261474
pcrVenus	VenusDel	22	5752	4	4	8	0.0006954103	0.0006954103	0.0013908206	5748	0.9993045897
pcrVenus	VenusDel	23	5752	10	0	10	0.0017385257	0	0.0017385257	5742	0.9982614743
pcrVenus	VenusDel	24	5752	10	0	10	0.0017385257	0	0.0017385257	5742	0.9982614743
pcrVenus	VenusDel	25	5752	18	5	23	0.0031293463	0.0008692629	0.0039986092	5734	0.9968706537
pcrVenus	VenusDel	26	5752	9	0	9	0.0015646732	0	0.0015646732	5743	0.9984353268
pcrVenus	VenusDel	27	5752	9	1	10	0.0015646732	0.0001738526	0.0017385257	5743	0.9984353268
pcrVenus	VenusDel	28	5752	247	18	265	0.0429415855	0.0031293463	0.0460709318	5505	0.9570584145
pcrVenus	VenusDel	29	5752	10	0	10	0.0017385257	0	0.0017385257	5742	0.9982614743
pcrVenus	VenusDel	30	5752	9	2	11	0.0015646732	0.0003477051	0.0019123783	5743	0.9984353268
pcrVenus	VenusDel	31	5752	9	1	10	0.0015646732	0.0001738526	0.0017385257	5743	0.9984353268
pcrVenus	VenusDel	32	5752	9	2	11	0.0015646732	0.0003477051	0.0019123783	5743	0.9984353268
pcrVenus	VenusDel	33	5752	13	7	20	0.0022600834	0.001216968	0.0034770515	5739	0.9977399166
pcrVenus	VenusDel	34	5752	9	0	9	0.0015646732	0	0.0015646732	5743	0.9984353268
pcrVenus	VenusDel	35	5752	9	1	10	0.0015646732	0.0001738526	0.0017385257	5743	0.9984353268
pcrVenus	VenusDel	36	5752	9	0	9	0.0015646732	0	0.0015646732	5743	0.9984353268
pcrVenus	VenusDel	37	5752	9	0	9	0.0015646732	0	0.0015646732	5743	0.9984353268
pcrVenus	VenusDel	38	5752	9	0	9	0.0015646732	0	0.0015646732	5743	0.9984353268
pcrVenus	VenusDel	39	5752	9	0	9	0.0015646732	0	0.0015646732	5743	0.9984353268
pcrVenus	VenusDel	40	5752	9	2	11	0.0015646732	0.0003477051	0.0019123783	5743	0.9984353268
pcrVenus	VenusDel	41	5752	9	0	9	0.0015646732	0	0.0015646732	5743	0.9984353268
pcrVenus	VenusDel	42	5752	12	2	14	0.0020862309	0.0003477051	0.002433936	5740	0.9979137691
pcrVenus	VenusDel	43	5752	9	3	12	0.0015646732	0.0005215577	0.0020862309	5743	0.9984353268
pcrVenus	VenusDel	44	5752	10	1	11	0.0017385257	0.0001738526	0.0019123783	5742	0.9982614743
pcrVenus	VenusDel	45	5752	28	19	47	0.004867872	0.0033031989	0.0081710709	5724	0.995132128
pcrVenus	VenusDel	46	5752	9	1	10	0.0015646732	0.0001738526	0.0017385257	5743	0.9984353268
pcrVenus	VenusDel	47	5752	10	0	10	0.0017385257	0	0.0017385257	5742	0.9982614743
pcrVenus	VenusDel	48	5752	10	1	11	0.0017385257	0.0001738526	0.0019123783	5742	0.9982614743
pcrVenus	VenusDel	49	5752	11	11	22	0.0019123783	0.0019123783	0.0038247566	5741	0.9980876217
pcrVenus	VenusDel	50	5752	9	0	9	0.0015646732	0	0.0015646732	5743	0.9984353268
pcrVenus	VenusDel	51	5752	9	2	11	0.0015646732	0.0003477051	0.0019123783	5743	0.9984353268
pcrVenus	VenusDel	52	5752	9	2	11	0.0015646732	0.0003477051	0.0019123783	5743	0.9984353268
pcrVenus	VenusDel	53	5753	9	0	9	0.0015644012	0	0.0015644012	5744	0.9984355988
pcrVenus	VenusDel	54	5753	37	2	39	0.0064314271	0.0003476447	0.0067790718	5716	0.9935685729
pcrVenus	VenusDel	55	5753	55	1	56	0.0095602294	0.0001738224	0.0097340518	5698	0.9904397706
pcrVenus	VenusDel	56	5753	56	2	58	0.0097340518	0.0003476447	0.0100816965	5697	0.9902659482
pcrVenus	VenusDel	57	5753	64	6	70	0.0111246306	0.0010429341	0.0121675647	5689	0.9888753694
pcrVenus	VenusDel	58	5753	63	1	64	0.0109508083	0.0001738224	0.0111246306	5690	0.9890491917
pcrVenus	VenusDel	59	5753	67	3	70	0.0116460977	0.0005214671	0.0121675647	5686	0.9883539023
pcrVenus	VenusDel	60	5753	64	3	67	0.0111246306	0.0005214671	0.0116460977	5689	0.9888753694
pcrVenus	VenusDel	61	5753	64	0	64	0.0111246306	0	0.0111246306	5689	0.9888753694
pcrVenus	VenusDel	62	5753	74	3	77	0.0128628542	0.0005214671	0.0133843212	5679	0.9871371458
pcrVenus	VenusDel	63	5753	63	0	63	0.0109508083	0	0.0109508083	5690	0.9890491917
pcrVenus	VenusDel	64	5753	63	5	68	0.0109508083	0.0008691118	0.01181992	5690	0.9890491917
pcrVenus	VenusDel	65	5753	63	4	67	0.0109508083	0.0006952894	0.0116460977	5690	0.9890491917
pcrVenus	VenusDel	66	5753	69	1	70	0.0119937424	0.0001738224	0.0121675647	5684	0.9880062576
pcrVenus	VenusDel	67	5753	80	3	83	0.0139057883	0.0005214671	0.0144272553	5673	0.9860942117
pcrVenus	VenusDel	68	5753	82	12	94	0.014253433	0.0020858682	0.0163393012	5671	0.985746567
pcrVenus	VenusDel	69	5753	80	2	82	0.0139057883	0.0003476447	0.014253433	5673	0.9860942117
pcrVenus	VenusDel	70	5753	80	3	83	0.0139057883	0.0005214671	0.0144272553	5673	0.9860942117
pcrVenus	VenusDel	71	5753	87	2	89	0.0151225448	0.0003476447	0.0154701895	5666	0.9848774552
pcrVenus	VenusDel	72	5753	84	1	85	0.0146010777	0.0001738224	0.0147749001	5669	0.9853989223
pcrVenus	VenusDel	73	5753	89	4	93	0.0154701895	0.0006952894	0.0161654789	5664	0.9845298105
pcrVenus	VenusDel	74	5753	89	2	91	0.0154701895	0.0003476447	0.0158178342	5664	0.9845298105
pcrVenus	VenusDel	75	5753	95	9	104	0.0165131236	0.0015644012	0.0180775248	5658	0.9834868764
pcrVenus	VenusDel	76	5753	131	4	135	0.0227707283	0.0006952894	0.0234660177	5622	0.9772292717
pcrVenus	VenusDel	77	5753	138	2	140	0.0239874848	0.0003476447	0.0243351295	5615	0.9760125152
pcrVenus	VenusDel	78	5753	187	19	206	0.0325047801	0.0033026247	0.0358074048	5566	0.9674952199
pcrVenus	VenusDel	79	5753	134	1	135	0.0232921954	0.0001738224	0.0234660177	5619	0.9767078046
pcrVenus	VenusDel	80	5753	141	9	150	0.0245089519	0.0015644012	0.026073353	5612	0.9754910481
pcrVenus	VenusDel	81	5753	175	0	175	0.0304189119	0	0.0304189119	5578	0.9695810881
pcrVenus	VenusDel	82	5753	177	10	187	0.0307665566	0.0017382235	0.0325047801	5576	0.9692334434
pcrVenus	VenusDel	83	5753	184	0	184	0.0319833131	0	0.0319833131	5569	0.9680166869
pcrVenus	VenusDel	84	5753	190	2	192	0.0330262472	0.0003476447	0.0333738919	5563	0.9669737528
pcrVenus	VenusDel	85	5753	355	6	361	0.0617069355	0.0010429341	0.0627498696	5398	0.9382930645
pcrVenus	VenusDel	86	5753	392	2	394	0.0681383626	0.0003476447	0.0684860073	5361	0.9318616374
pcrVenus	VenusDel	87	5753	521	10	531	0.0905614462	0.0017382235	0.0922996697	5232	0.9094385538
pcrVenus	VenusDel	88	5753	570	1	571	0.0990787415	0.0001738224	0.0992525639	5183	0.9009212585
pcrVenus	VenusDel	89	5753	596	3	599	0.1035981227	0.0005214671	0.1041195898	5157	0.8964018773
pcrVenus	VenusDel	90	5753	673	0	673	0.1169824439	0	0.1169824439	5080	0.8830175561
pcrVenus	VenusDel	91	5753	734	7	741	0.1275856075	0.0012167565	0.128802364	5019	0.8724143925
pcrVenus	VenusDel	92	5753	767	0	767	0.1333217452	0	0.1333217452	4986	0.8666782548
pcrVenus	VenusDel	93	5753	794	5	799	0.1380149487	0.0008691118	0.1388840605	4959	0.8619850513
pcrVenus	VenusDel	94	5753	877	0	877	0.1524422041	0	0.1524422041	4876	0.8475577959
pcrVenus	VenusDel	95	5753	923	15	938	0.1604380323	0.0026073353	0.1630453676	4830	0.8395619677
pcrVenus	VenusDel	96	5753	985	51	1036	0.1712150183	0.00886494	0.1800799583	4768	0.8287849817
pcrVenus	VenusDel	97	5753	1076	1	1077	0.1870328524	0.0001738224	0.1872066748	4677	0.8129671476
pcrVenus	VenusDel	98	5753	1068	9	1077	0.1856422736	0.0015644012	0.1872066748	4685	0.8143577264
pcrVenus	VenusDel	99	5753	1112	4	1116	0.1932904572	0.0006952894	0.1939857466	4641	0.8067095428
pcrVenus	VenusDel	100	5753	1138	2	1140	0.1978098383	0.0003476447	0.1981574831	4615	0.8021901617
pcrVenus	VenusDel	101	5753	1577	63	1640	0.2741178516	0.0109508083	0.2850686598	4176	0.7258821484
pcrVenus	VenusDel	102	5753	1643	6	1649	0.2855901269	0.0010429341	0.286633061	4110	0.7144098731
pcrVenus	VenusDel	103	5753	2428	1504	3932	0.4220406744	0.2614288197	0.6834694942	3325	0.5779593256
pcrVenus	VenusDel	104	5753	1438	493	1931	0.2499565444	0.0856944203	0.3356509647	4315	0.7500434556
pcrVenus	VenusDel	105	5753	1694	18	1712	0.2944550669	0.0031288024	0.2975838693	4059	0.7055449331
pcrVenus	VenusDel	106	5753	1255	19	1274	0.2181470537	0.0033026247	0.2214496784	4498	0.7818529463
pcrVenus	VenusDel	107	5753	1150	1	1151	0.1998957066	0.0001738224	0.2000695289	4603	0.8001042934
pcrVenus	VenusDel	108	5753	1016	2	1018	0.1766035112	0.0003476447	0.1769511559	4737	0.8233964888
pcrVenus	VenusDel	109	5753	886	8	894	0.1540066052	0.0013905788	0.1553971841	4867	0.8459933948
pcrVenus	VenusDel	110	5753	792	0	792	0.137667304	0	0.137667304	4961	0.862332696
pcrVenus	VenusDel	111	5753	745	11	756	0.1294976534	0.0019120459	0.1314096993	5008	0.8705023466
pcrVenus	VenusDel	112	5753	626	4	630	0.1088127933	0.0006952894	0.1095080827	5127	0.8911872067
pcrVenus	VenusDel	113	5753	620	14	634	0.1077698592	0.0024335129	0.1102033722	5133	0.8922301408
pcrVenus	VenusDel	114	5753	522	3	525	0.0907352686	0.0005214671	0.0912567356	5231	0.9092647314
pcrVenus	VenusDel	115	5753	471	14	485	0.0818703285	0.0024335129	0.0843038415	5282	0.9181296715
pcrVenus	VenusDel	116	5753	461	57	518	0.080132105	0.0099078742	0.0900399791	5292	0.919867895
pcrVenus	VenusDel	117	5753	416	1	417	0.0723100991	0.0001738224	0.0724839214	5337	0.9276899009
pcrVenus	VenusDel	118	5753	429	16	445	0.0745697897	0.0027811577	0.0773509473	5324	0.9254302103
pcrVenus	VenusDel	119	5753	418	1	419	0.0726577438	0.0001738224	0.0728315661	5335	0.9273422562
pcrVenus	VenusDel	120	5753	386	10	396	0.0670954285	0.0017382235	0.068833652	5367	0.9329045715
pcrVenus	VenusDel	121	5753	360	10	370	0.0625760473	0.0017382235	0.0643142708	5393	0.9374239527
pcrVenus	VenusDel	122	5753	363	33	396	0.0630975143	0.0057361377	0.068833652	5390	0.9369024857
pcrVenus	VenusDel	123	5753	321	61	382	0.0557969755	0.0106031636	0.0664001391	5432	0.9442030245
pcrVenus	VenusDel	124	5753	309	0	309	0.0537111072	0	0.0537111072	5444	0.9462888928
pcrVenus	VenusDel	125	5753	313	4	317	0.0544063967	0.0006952894	0.0551016861	5440	0.9455936033
pcrVenus	VenusDel	126	5753	313	8	321	0.0544063967	0.0013905788	0.0557969755	5440	0.9455936033
pcrVenus	VenusDel	127	5753	287	14	301	0.0498870155	0.0024335129	0.0523205284	5466	0.9501129845
pcrVenus	VenusDel	128	5753	255	40	295	0.0443247002	0.0069528941	0.0512775943	5498	0.9556752998
pcrVenus	VenusDel	129	5753	223	24	247	0.0387623848	0.0041717365	0.0429341213	5530	0.9612376152
pcrVenus	VenusDel	130	5753	225	17	242	0.0391100295	0.00295498	0.0420650096	5528	0.9608899705
pcrVenus	VenusDel	131	5753	221	22	243	0.0384147401	0.0038240918	0.0422388319	5532	0.9615852599
pcrVenus	VenusDel	132	5753	222	37	259	0.0385885625	0.0064314271	0.0450199896	5531	0.9614114375
pcrVenus	VenusDel	133	5753	221	9	230	0.0384147401	0.0015644012	0.0399791413	5532	0.9615852599
pcrVenus	VenusDel	134	5753	206	50	256	0.0358074048	0.0086911177	0.0444985225	5547	0.9641925952
pcrVenus	VenusDel	135	5753	206	2	208	0.0358074048	0.0003476447	0.0361550495	5547	0.9641925952
pcrVenus	VenusDel	136	5753	206	2	208	0.0358074048	0.0003476447	0.0361550495	5547	0.9641925952
pcrVenus	VenusDel	137	5753	208	4	212	0.0361550495	0.0006952894	0.036850339	5545	0.9638449505
pcrVenus	VenusDel	138	5753	206	50	256	0.0358074048	0.0086911177	0.0444985225	5547	0.9641925952
pcrVenus	VenusDel	139	5753	193	3	196	0.0335477142	0.0005214671	0.0340691813	5560	0.9664522858
pcrVenus	VenusDel	140	5753	193	1	194	0.0335477142	0.0001738224	0.0337215366	5560	0.9664522858
pcrVenus	VenusDel	141	5753	194	1	195	0.0337215366	0.0001738224	0.0338953589	5559	0.9662784634
pcrVenus	VenusDel	142	5753	189	7	196	0.0328524248	0.0012167565	0.0340691813	5564	0.9671475752
pcrVenus	VenusDel	143	5753	189	51	240	0.0328524248	0.00886494	0.0417173649	5564	0.9671475752
pcrVenus	VenusDel	144	5753	184	5	189	0.0319833131	0.0008691118	0.0328524248	5569	0.9680166869
pcrVenus	VenusDel	145	5753	182	0	182	0.0316356683	0	0.0316356683	5571	0.9683643317
pcrVenus	VenusDel	146	5753	194	8	202	0.0337215366	0.0013905788	0.0351121154	5559	0.9662784634
pcrVenus	VenusDel	147	5753	182	1	183	0.0316356683	0.0001738224	0.0318094907	5571	0.9683643317
pcrVenus	VenusDel	148	5753	182	49	231	0.0316356683	0.0085172953	0.0401529637	5571	0.9683643317
pcrVenus	VenusDel	149	5753	183	0	183	0.0318094907	0	0.0318094907	5570	0.9681905093
pcrVenus	VenusDel	150	5753	182	2	184	0.0316356683	0.0003476447	0.0319833131	5571	0.9683643317
pcrVenus	VenusDel	151	5753	182	0	182	0.0316356683	0	0.0316356683	5571	0.9683643317
pcrVenus	VenusDel	152	5753	188	2	190	0.0326786025	0.0003476447	0.0330262472	5565	0.9673213975
pcrVenus	VenusDel	153	5753	182	48	230	0.0316356683	0.008343473	0.0399791413	5571	0.9683643317
pcrVenus	VenusDel	154	5753	182	3	185	0.0316356683	0.0005214671	0.0321571354	5571	0.9683643317
pcrVenus	VenusDel	155	5753	181	0	181	0.031461846	0	0.031461846	5572	0.968538154
pcrVenus	VenusDel	156	5753	182	3	185	0.0316356683	0.0005214671	0.0321571354	5571	0.9683643317
pcrVenus	VenusDel	157	5753	181	4	185	0.031461846	0.0006952894	0.0321571354	5572	0.968538154
pcrVenus	VenusDel	158	5753	181	54	235	0.031461846	0.0093864071	0.0408482531	5572	0.968538154
pcrVenus	VenusDel	159	5753	183	20	203	0.0318094907	0.0034764471	0.0352859378	5570	0.9681905093
pcrVenus	VenusDel	160	5753	181	1	182	0.031461846	0.0001738224	0.0316356683	5572	0.968538154
pcrVenus	VenusDel	161	5753	181	1	182	0.031461846	0.0001738224	0.0316356683	5572	0.968538154
pcrVenus	VenusDel	162	5753	182	1	183	0.0316356683	0.0001738224	0.0318094907	5571	0.9683643317
pcrVenus	VenusDel	163	5753	183	5	188	0.0318094907	0.0008691118	0.0326786025	5570	0.9681905093
pcrVenus	VenusDel	164	5753	181	2	183	0.031461846	0.0003476447	0.0318094907	5572	0.968538154
pcrVenus	VenusDel	165	5753	261	36	297	0.0453676343	0.0062576047	0.051625239	5492	0.9546323657
pcrVenus	VenusDel	166	5753	181	0	181	0.031461846	0	0.031461846	5572	0.968538154
pcrVenus	VenusDel	167	5753	174	49	223	0.0302450895	0.0085172953	0.0387623848	5579	0.9697549105
pcrVenus	VenusDel	168	5753	174	2	176	0.0302450895	0.0003476447	0.0305927342	5579	0.9697549105
pcrVenus	VenusDel	169	5753	173	0	173	0.0300712672	0	0.0300712672	5580	0.9699287328
pcrVenus	VenusDel	170	5753	179	13	192	0.0311142013	0.0022596906	0.0333738919	5574	0.9688857987
pcrVenus	VenusDel	171	5753	173	2	175	0.0300712672	0.0003476447	0.0304189119	5580	0.9699287328
pcrVenus	VenusDel	172	5753	172	1	173	0.0298974448	0.0001738224	0.0300712672	5581	0.9701025552
pcrVenus	VenusDel	173	5753	173	6	179	0.0300712672	0.0010429341	0.0311142013	5580	0.9699287328
pcrVenus	VenusDel	174	5753	184	10	194	0.0319833131	0.0017382235	0.0337215366	5569	0.9680166869
pcrVenus	VenusDel	175	5753	172	1	173	0.0298974448	0.0001738224	0.0300712672	5581	0.9701025552
pcrVenus	VenusDel	176	5753	174	1	175	0.0302450895	0.0001738224	0.0304189119	5579	0.9697549105
pcrVenus	VenusDel	177	5753	140	1	141	0.0243351295	0.0001738224	0.0245089519	5613	0.9756648705
pcrVenus	VenusDel	178	5753	141	3	144	0.0245089519	0.0005214671	0.0250304189	5612	0.9754910481
pcrVenus	VenusDel	179	5753	142	3	145	0.0246827742	0.0005214671	0.0252042413	5611	0.9753172258
pcrVenus	VenusDel	180	5753	134	0	134	0.0232921954	0	0.0232921954	5619	0.9767078046
pcrVenus	VenusDel	181	5753	135	2	137	0.0234660177	0.0003476447	0.0238136624	5618	0.9765339823
pcrVenus	VenusDel	182	5753	134	9	143	0.0232921954	0.0015644012	0.0248565966	5619	0.9767078046
pcrVenus	VenusDel	183	5753	134	0	134	0.0232921954	0	0.0232921954	5619	0.9767078046
pcrVenus	VenusDel	184	5753	134	2	136	0.0232921954	0.0003476447	0.0236398401	5619	0.9767078046
pcrVenus	VenusDel	185	5753	132	50	182	0.0229445507	0.0086911177	0.0316356683	5621	0.9770554493
pcrVenus	VenusDel	186	5753	132	1	133	0.0229445507	0.0001738224	0.023118373	5621	0.9770554493
pcrVenus	VenusDel	187	5753	132	3	135	0.0229445507	0.0005214671	0.0234660177	5621	0.9770554493
pcrVenus	VenusDel	188	5753	132	2	134	0.0229445507	0.0003476447	0.0232921954	5621	0.9770554493
pcrVenus	VenusDel	189	5753	132	0	132	0.0229445507	0	0.0229445507	5621	0.9770554493
pcrVenus	VenusDel	190	5753	132	2	134	0.0229445507	0.0003476447	0.0232921954	5621	0.9770554493
pcrVenus	VenusDel	191	5753	132	5	137	0.0229445507	0.0008691118	0.0238136624	5621	0.9770554493
pcrVenus	VenusDel	192	5753	132	1	133	0.0229445507	0.0001738224	0.023118373	5621	0.9770554493
pcrVenus	VenusDel	193	5753	132	2	134	0.0229445507	0.0003476447	0.0232921954	5621	0.9770554493
pcrVenus	VenusDel	194	5753	132	3	135	0.0229445507	0.0005214671	0.0234660177	5621	0.9770554493
pcrVenus	VenusDel	195	5753	135	7	142	0.0234660177	0.0012167565	0.0246827742	5618	0.9765339823
pcrVenus	VenusDel	196	5753	132	0	132	0.0229445507	0	0.0229445507	5621	0.9770554493
pcrVenus	VenusDel	197	5753	132	1	133	0.0229445507	0.0001738224	0.023118373	5621	0.9770554493
pcrVenus	VenusDel	198	5753	132	3	135	0.0229445507	0.0005214671	0.0234660177	5621	0.9770554493
pcrVenus	VenusDel	199	5753	131	1	132	0.0227707283	0.0001738224	0.0229445507	5622	0.9772292717
pcrVenus	VenusDel	200	5753	131	8	139	0.0227707283	0.0013905788	0.0241613071	5622	0.9772292717
pcrVenus	VenusDel	201	5753	131	51	182	0.0227707283	0.00886494	0.0316356683	5622	0.9772292717
pcrVenus	VenusDel	202	5753	131	2	133	0.0227707283	0.0003476447	0.023118373	5622	0.9772292717
pcrVenus	VenusDel	203	5753	150	8	158	0.026073353	0.0013905788	0.0274639319	5603	0.973926647
pcrVenus	VenusDel	204	5753	131	0	131	0.0227707283	0	0.0227707283	5622	0.9772292717
pcrVenus	VenusDel	205	5753	131	0	131	0.0227707283	0	0.0227707283	5622	0.9772292717
pcrVenus	VenusDel	206	5753	131	1	132	0.0227707283	0.0001738224	0.0229445507	5622	0.9772292717
pcrVenus	VenusDel	207	5753	179	4	183	0.0311142013	0.0006952894	0.0318094907	5574	0.9688857987
pcrVenus	VenusDel	208	5753	176	0	176	0.0305927342	0	0.0305927342	5577	0.9694072658
pcrVenus	VenusDel	209	5753	132	11	143	0.0229445507	0.0019120459	0.0248565966	5621	0.9770554493
pcrVenus	VenusDel	210	5753	76	3	79	0.0132104989	0.0005214671	0.0137319659	5677	0.9867895011
pcrVenus	VenusDel	211	5753	76	3	79	0.0132104989	0.0005214671	0.0137319659	5677	0.9867895011
pcrVenus	VenusDel	212	5753	76	48	124	0.0132104989	0.008343473	0.0215539718	5677	0.9867895011
pcrVenus	VenusDel	213	5753	80	61	141	0.0139057883	0.0106031636	0.0245089519	5673	0.9860942117
pcrVenus	VenusDel	214	5753	76	46	122	0.0132104989	0.0079958283	0.0212063271	5677	0.9867895011
pcrVenus	VenusDel	215	5753	76	1	77	0.0132104989	0.0001738224	0.0133843212	5677	0.9867895011
pcrVenus	VenusDel	216	5753	78	5	83	0.0135581436	0.0008691118	0.0144272553	5675	0.9864418564
pcrVenus	VenusDel	217	5753	76	1	77	0.0132104989	0.0001738224	0.0133843212	5677	0.9867895011
pcrVenus	VenusDel	218	5753	76	1	77	0.0132104989	0.0001738224	0.0133843212	5677	0.9867895011
pcrVenus	VenusDel	219	5753	76	1	77	0.0132104989	0.0001738224	0.0133843212	5677	0.9867895011
pcrVenus	VenusDel	220	5753	77	1	78	0.0133843212	0.0001738224	0.0135581436	5676	0.9866156788
pcrVenus	VenusDel	221	5753	76	1	77	0.0132104989	0.0001738224	0.0133843212	5677	0.9867895011
pcrVenus	VenusDel	222	5753	76	6	82	0.0132104989	0.0010429341	0.014253433	5677	0.9867895011
pcrVenus	VenusDel	223	5753	77	1	78	0.0133843212	0.0001738224	0.0135581436	5676	0.9866156788
pcrVenus	VenusDel	224	5753	77	6	83	0.0133843212	0.0010429341	0.0144272553	5676	0.9866156788
pcrVenus	VenusDel	225	5753	75	13	88	0.0130366765	0.0022596906	0.0152963671	5678	0.9869633235
pcrVenus	VenusDel	226	5753	76	4	80	0.0132104989	0.0006952894	0.0139057883	5677	0.9867895011
pcrVenus	VenusDel	227	5753	61	7	68	0.0106031636	0.0012167565	0.01181992	5692	0.9893968364
pcrVenus	VenusDel	228	5753	65	75	140	0.011298453	0.0130366765	0.0243351295	5688	0.988701547
pcrVenus	VenusDel	229	5753	60	0	60	0.0104293412	0	0.0104293412	5693	0.9895706588
pcrVenus	VenusDel	230	5753	59	3	62	0.0102555189	0.0005214671	0.0107769859	5694	0.9897444811
pcrVenus	VenusDel	231	5753	59	6	65	0.0102555189	0.0010429341	0.011298453	5694	0.9897444811
pcrVenus	VenusDel	232	5753	59	1	60	0.0102555189	0.0001738224	0.0104293412	5694	0.9897444811
pcrVenus	VenusDel	233	5753	72	16	88	0.0125152095	0.0027811577	0.0152963671	5681	0.9874847905
pcrVenus	VenusDel	234	5753	59	0	59	0.0102555189	0	0.0102555189	5694	0.9897444811
pcrVenus	VenusDel	235	5753	59	0	59	0.0102555189	0	0.0102555189	5694	0.9897444811
pcrVenus	VenusDel	236	5753	59	2	61	0.0102555189	0.0003476447	0.0106031636	5694	0.9897444811
pcrVenus	VenusDel	237	5753	59	51	110	0.0102555189	0.00886494	0.0191204589	5694	0.9897444811
pcrVenus	VenusDel	238	5753	61	0	61	0.0106031636	0	0.0106031636	5692	0.9893968364
pcrVenus	VenusDel	239	5753	69	18	87	0.0119937424	0.0031288024	0.0151225448	5684	0.9880062576
pcrVenus	VenusDel	240	5753	59	0	59	0.0102555189	0	0.0102555189	5694	0.9897444811
pcrVenus	VenusDel	241	5753	59	0	59	0.0102555189	0	0.0102555189	5694	0.9897444811
pcrVenus	VenusDel	242	5753	59	4	63	0.0102555189	0.0006952894	0.0109508083	5694	0.9897444811
pcrVenus	VenusDel	243	5753	59	2	61	0.0102555189	0.0003476447	0.0106031636	5694	0.9897444811
pcrVenus	VenusDel	244	5753	59	0	59	0.0102555189	0	0.0102555189	5694	0.9897444811
pcrVenus	VenusDel	245	5753	59	1	60	0.0102555189	0.0001738224	0.0104293412	5694	0.9897444811
pcrVenus	VenusDel	246	5753	60	1	61	0.0104293412	0.0001738224	0.0106031636	5693	0.9895706588
pcrVenus	VenusDel	247	5753	74	4	78	0.0128628542	0.0006952894	0.0135581436	5679	0.9871371458
pcrVenus	VenusDel	248	5753	59	0	59	0.0102555189	0	0.0102555189	5694	0.9897444811
pcrVenus	VenusDel	249	5753	60	5	65	0.0104293412	0.0008691118	0.011298453	5693	0.9895706588
pcrVenus	VenusDel	250	5753	69	52	121	0.0119937424	0.0090387624	0.0210325048	5684	0.9880062576
pcrVenus	VenusDel	251	5753	59	0	59	0.0102555189	0	0.0102555189	5694	0.9897444811
pcrVenus	VenusDel	252	5753	63	6	69	0.0109508083	0.0010429341	0.0119937424	5690	0.9890491917
pcrVenus	VenusDel	253	5753	59	31	90	0.0102555189	0.005388493	0.0156440118	5694	0.9897444811
pcrVenus	VenusDel	254	5753	59	50	109	0.0102555189	0.0086911177	0.0189466365	5694	0.9897444811
pcrVenus	VenusDel	255	5753	61	5	66	0.0106031636	0.0008691118	0.0114722753	5692	0.9893968364
pcrVenus	VenusDel	256	5753	59	0	59	0.0102555189	0	0.0102555189	5694	0.9897444811
pcrVenus	VenusDel	257	5753	49	0	49	0.0085172953	0	0.0085172953	5704	0.9914827047
pcrVenus	VenusDel	258	5753	54	7	61	0.0093864071	0.0012167565	0.0106031636	5699	0.9906135929
pcrVenus	VenusDel	259	5753	49	0	49	0.0085172953	0	0.0085172953	5704	0.9914827047
pcrVenus	VenusDel	260	5753	49	0	49	0.0085172953	0	0.0085172953	5704	0.9914827047
pcrVenus	VenusDel	261	5753	50	3	53	0.0086911177	0.0005214671	0.0092125847	5703	0.9913088823
pcrVenus	VenusDel	262	5753	50	0	50	0.0086911177	0	0.0086911177	5703	0.9913088823
pcrVenus	VenusDel	263	5753	50	1	51	0.0086911177	0.0001738224	0.00886494	5703	0.9913088823
pcrVenus	VenusDel	264	5753	50	2	52	0.0086911177	0.0003476447	0.0090387624	5703	0.9913088823
pcrVenus	VenusDel	265	5753	63	57	120	0.0109508083	0.0099078742	0.0208586824	5690	0.9890491917
pcrVenus	VenusDel	266	5753	50	0	50	0.0086911177	0	0.0086911177	5703	0.9913088823
pcrVenus	VenusDel	267	5753	41	0	41	0.0071267165	0	0.0071267165	5712	0.9928732835
pcrVenus	VenusDel	268	5753	41	3	44	0.0071267165	0.0005214671	0.0076481836	5712	0.9928732835
pcrVenus	VenusDel	269	5753	41	1	42	0.0071267165	0.0001738224	0.0073005388	5712	0.9928732835
pcrVenus	VenusDel	270	5753	46	8	54	0.0079958283	0.0013905788	0.0093864071	5707	0.9920041717
pcrVenus	VenusDel	271	5753	41	1	42	0.0071267165	0.0001738224	0.0073005388	5712	0.9928732835
pcrVenus	VenusDel	272	5753	41	4	45	0.0071267165	0.0006952894	0.0078220059	5712	0.9928732835
pcrVenus	VenusDel	273	5753	44	6	50	0.0076481836	0.0010429341	0.0086911177	5709	0.9923518164
pcrVenus	VenusDel	274	5753	41	5	46	0.0071267165	0.0008691118	0.0079958283	5712	0.9928732835
pcrVenus	VenusDel	275	5753	41	18	59	0.0071267165	0.0031288024	0.0102555189	5712	0.9928732835
pcrVenus	VenusDel	276	5753	40	14	54	0.0069528941	0.0024335129	0.0093864071	5713	0.9930471059
pcrVenus	VenusDel	277	5753	40	1	41	0.0069528941	0.0001738224	0.0071267165	5713	0.9930471059
pcrVenus	VenusDel	278	5753	41	0	41	0.0071267165	0	0.0071267165	5712	0.9928732835
pcrVenus	VenusDel	279	5753	40	2	42	0.0069528941	0.0003476447	0.0073005388	5713	0.9930471059
pcrVenus	VenusDel	280	5753	40	1	41	0.0069528941	0.0001738224	0.0071267165	5713	0.9930471059
pcrVenus	VenusDel	281	5753	40	7	47	0.0069528941	0.0012167565	0.0081696506	5713	0.9930471059
pcrVenus	VenusDel	282	5753	40	1	41	0.0069528941	0.0001738224	0.0071267165	5713	0.9930471059
pcrVenus	VenusDel	283	5753	39	2	41	0.0067790718	0.0003476447	0.0071267165	5714	0.9932209282
pcrVenus	VenusDel	284	5753	35	0	35	0.0060837824	0	0.0060837824	5718	0.9939162176
pcrVenus	VenusDel	285	5753	35	4	39	0.0060837824	0.0006952894	0.0067790718	5718	0.9939162176
pcrVenus	VenusDel	286	5753	43	3	46	0.0074743612	0.0005214671	0.0079958283	5710	0.9925256388
pcrVenus	VenusDel	287	5753	35	0	35	0.0060837824	0	0.0060837824	5718	0.9939162176
pcrVenus	VenusDel	288	5753	37	6	43	0.0064314271	0.0010429341	0.0074743612	5716	0.9935685729
pcrVenus	VenusDel	289	5753	35	0	35	0.0060837824	0	0.0060837824	5718	0.9939162176
pcrVenus	VenusDel	290	5753	35	2	37	0.0060837824	0.0003476447	0.0064314271	5718	0.9939162176
pcrVenus	VenusDel	291	5753	35	12	47	0.0060837824	0.0020858682	0.0081696506	5718	0.9939162176
pcrVenus	VenusDel	292	5753	35	1	36	0.0060837824	0.0001738224	0.0062576047	5718	0.9939162176
pcrVenus	VenusDel	293	5753	35	3	38	0.0060837824	0.0005214671	0.0066052494	5718	0.9939162176
pcrVenus	VenusDel	294	5753	35	0	35	0.0060837824	0	0.0060837824	5718	0.9939162176
pcrVenus	VenusDel	295	5753	35	3	38	0.0060837824	0.0005214671	0.0066052494	5718	0.9939162176
pcrVenus	VenusDel	296	5753	35	4	39	0.0060837824	0.0006952894	0.0067790718	5718	0.9939162176
pcrVenus	VenusDel	297	5753	47	11	58	0.0081696506	0.0019120459	0.0100816965	5706	0.9918303494
pcrVenus	VenusDel	298	5753	35	0	35	0.0060837824	0	0.0060837824	5718	0.9939162176
pcrVenus	VenusDel	299	5753	35	0	35	0.0060837824	0	0.0060837824	5718	0.9939162176
pcrVenus	VenusDel	300	5753	35	1	36	0.0060837824	0.0001738224	0.0062576047	5718	0.9939162176
pcrVenus	VenusDel	301	5753	35	2	37	0.0060837824	0.0003476447	0.0064314271	5718	0.9939162176
pcrVenus	VenusDel	302	5753	35	0	35	0.0060837824	0	0.0060837824	5718	0.9939162176
pcrVenus	VenusDel	303	5753	44	55	99	0.0076481836	0.0095602294	0.017208413	5709	0.9923518164
pcrVenus	VenusDel	304	5753	35	0	35	0.0060837824	0	0.0060837824	5718	0.9939162176
pcrVenus	VenusDel	305	5753	35	1	36	0.0060837824	0.0001738224	0.0062576047	5718	0.9939162176
pcrVenus	VenusDel	306	5753	35	48	83	0.0060837824	0.008343473	0.0144272553	5718	0.9939162176
pcrVenus	VenusDel	307	5753	37	53	90	0.0064314271	0.0092125847	0.0156440118	5716	0.9935685729
pcrVenus	VenusDel	308	5753	35	0	35	0.0060837824	0	0.0060837824	5718	0.9939162176
pcrVenus	VenusDel	309	5753	57	13	70	0.0099078742	0.0022596906	0.0121675647	5696	0.9900921258
pcrVenus	VenusDel	310	5753	35	0	35	0.0060837824	0	0.0060837824	5718	0.9939162176
pcrVenus	VenusDel	311	5753	36	0	36	0.0062576047	0	0.0062576047	5717	0.9937423953
pcrVenus	VenusDel	312	5753	37	0	37	0.0064314271	0	0.0064314271	5716	0.9935685729
pcrVenus	VenusDel	313	5753	58	6	64	0.0100816965	0.0010429341	0.0111246306	5695	0.9899183035
pcrVenus	VenusDel	314	5753	35	1	36	0.0060837824	0.0001738224	0.0062576047	5718	0.9939162176
pcrVenus	VenusDel	315	5753	35	0	35	0.0060837824	0	0.0060837824	5718	0.9939162176
pcrVenus	VenusDel	316	5753	35	0	35	0.0060837824	0	0.0060837824	5718	0.9939162176
pcrVenus	VenusDel	317	5753	35	6	41	0.0060837824	0.0010429341	0.0071267165	5718	0.9939162176
pcrVenus	VenusDel	318	5753	35	5	40	0.0060837824	0.0008691118	0.0069528941	5718	0.9939162176
pcrVenus	VenusDel	319	5753	35	0	35	0.0060837824	0	0.0060837824	5718	0.9939162176
pcrVenus	VenusDel	320	5753	35	6	41	0.0060837824	0.0010429341	0.0071267165	5718	0.9939162176
pcrVenus	VenusDel	321	5753	35	2	37	0.0060837824	0.0003476447	0.0064314271	5718	0.9939162176
pcrVenus	VenusDel	322	5753	39	5	44	0.0067790718	0.0008691118	0.0076481836	5714	0.9932209282
pcrVenus	VenusDel	323	5753	35	0	35	0.0060837824	0	0.0060837824	5718	0.9939162176
pcrVenus	VenusDel	324	5753	35	1	36	0.0060837824	0.0001738224	0.0062576047	5718	0.9939162176
pcrVenus	VenusDel	325	5753	46	11	57	0.0079958283	0.0019120459	0.0099078742	5707	0.9920041717
pcrVenus	VenusDel	326	5753	35	0	35	0.0060837824	0	0.0060837824	5718	0.9939162176
pcrVenus	VenusDel	327	5753	35	0	35	0.0060837824	0	0.0060837824	5718	0.9939162176
pcrVenus	VenusDel	328	5753	17	1	18	0.00295498	0.0001738224	0.0031288024	5736	0.99704502
pcrVenus	VenusDel	329	5753	35	17	52	0.0060837824	0.00295498	0.0090387624	5718	0.9939162176
pcrVenus	VenusDel	330	5753	16	4	20	0.0027811577	0.0006952894	0.0034764471	5737	0.9972188423
pcrVenus	VenusDel	331	5753	17	3	20	0.00295498	0.0005214671	0.0034764471	5736	0.99704502
pcrVenus	VenusDel	332	5753	17	18	35	0.00295498	0.0031288024	0.0060837824	5736	0.99704502
pcrVenus	VenusDel	333	5753	18	3	21	0.0031288024	0.0005214671	0.0036502694	5735	0.9968711976
pcrVenus	VenusDel	334	5753	16	3	19	0.0027811577	0.0005214671	0.0033026247	5737	0.9972188423
pcrVenus	VenusDel	335	5753	16	3	19	0.0027811577	0.0005214671	0.0033026247	5737	0.9972188423
pcrVenus	VenusDel	336	5753	19	5	24	0.0033026247	0.0008691118	0.0041717365	5734	0.9966973753
pcrVenus	VenusDel	337	5753	16	0	16	0.0027811577	0	0.0027811577	5737	0.9972188423
pcrVenus	VenusDel	338	5753	27	5	32	0.0046932035	0.0008691118	0.0055623153	5726	0.9953067965
pcrVenus	VenusDel	339	5753	16	0	16	0.0027811577	0	0.0027811577	5737	0.9972188423
pcrVenus	VenusDel	340	5753	16	24	40	0.0027811577	0.0041717365	0.0069528941	5737	0.9972188423
pcrVenus	VenusDel	341	5753	16	0	16	0.0027811577	0	0.0027811577	5737	0.9972188423
pcrVenus	VenusDel	342	5753	16	2	18	0.0027811577	0.0003476447	0.0031288024	5737	0.9972188423
pcrVenus	VenusDel	343	5753	16	1	17	0.0027811577	0.0001738224	0.00295498	5737	0.9972188423
pcrVenus	VenusDel	344	5753	16	1	17	0.0027811577	0.0001738224	0.00295498	5737	0.9972188423
pcrVenus	VenusDel	345	5753	16	0	16	0.0027811577	0	0.0027811577	5737	0.9972188423
pcrVenus	VenusDel	346	5753	16	5	21	0.0027811577	0.0008691118	0.0036502694	5737	0.9972188423
pcrVenus	VenusDel	347	5753	17	0	17	0.00295498	0	0.00295498	5736	0.99704502
pcrVenus	VenusDel	348	5753	16	2	18	0.0027811577	0.0003476447	0.0031288024	5737	0.9972188423
pcrVenus	VenusDel	349	5753	16	0	16	0.0027811577	0	0.0027811577	5737	0.9972188423
pcrVenus	VenusDel	350	5753	16	0	16	0.0027811577	0	0.0027811577	5737	0.9972188423
pcrVenus	VenusDel	351	5753	16	2	18	0.0027811577	0.0003476447	0.0031288024	5737	0.9972188423
pcrVenus	VenusDel	352	5753	48	17	65	0.008343473	0.00295498	0.011298453	5705	0.991656527
pcrVenus	VenusDel	353	5753	16	0	16	0.0027811577	0	0.0027811577	5737	0.9972188423
pcrVenus	VenusDel	354	5753	16	0	16	0.0027811577	0	0.0027811577	5737	0.9972188423
pcrVenus	VenusDel	355	5753	16	2	18	0.0027811577	0.0003476447	0.0031288024	5737	0.9972188423
pcrVenus	VenusDel	356	5753	16	2	18	0.0027811577	0.0003476447	0.0031288024	5737	0.9972188423
pcrVenus	VenusDel	357	5753	16	4	20	0.0027811577	0.0006952894	0.0034764471	5737	0.9972188423
pcrVenus	VenusDel	358	5753	16	1	17	0.0027811577	0.0001738224	0.00295498	5737	0.9972188423
pcrVenus	VenusDel	359	5753	66	138	204	0.0114722753	0.0239874848	0.0354597601	5687	0.9885277247
pcrVenus	VenusDel	360	5753	16	0	16	0.0027811577	0	0.0027811577	5737	0.9972188423
pcrVenus	VenusDel	361	5753	16	3	19	0.0027811577	0.0005214671	0.0033026247	5737	0.9972188423
pcrVenus	VenusDel	362	5753	16	1	17	0.0027811577	0.0001738224	0.00295498	5737	0.9972188423
pcrVenus	VenusDel	363	5753	16	1	17	0.0027811577	0.0001738224	0.00295498	5737	0.9972188423
pcrVenus	VenusDel	364	5753	16	1	17	0.0027811577	0.0001738224	0.00295498	5737	0.9972188423
pcrVenus	VenusDel	365	5753	24	5	29	0.0041717365	0.0008691118	0.0050408483	5729	0.9958282635
pcrVenus	VenusDel	366	5753	16	1	17	0.0027811577	0.0001738224	0.00295498	5737	0.9972188423
pcrVenus	VenusDel	367	5753	16	5	21	0.0027811577	0.0008691118	0.0036502694	5737	0.9972188423
pcrVenus	VenusDel	368	5753	16	0	16	0.0027811577	0	0.0027811577	5737	0.9972188423
pcrVenus	VenusDel	369	5753	16	3	19	0.0027811577	0.0005214671	0.0033026247	5737	0.9972188423
pcrVenus	VenusDel	370	5753	16	0	16	0.0027811577	0	0.0027811577	5737	0.9972188423
pcrVenus	VenusDel	371	5753	16	0	16	0.0027811577	0	0.0027811577	5737	0.9972188423
pcrVenus	VenusDel	372	5753	20	4	24	0.0034764471	0.0006952894	0.0041717365	5733	0.9965235529
pcrVenus	VenusDel	373	5753	16	1	17	0.0027811577	0.0001738224	0.00295498	5737	0.9972188423
pcrVenus	VenusDel	374	5753	16	2	18	0.0027811577	0.0003476447	0.0031288024	5737	0.9972188423
pcrVenus	VenusDel	375	5753	16	0	16	0.0027811577	0	0.0027811577	5737	0.9972188423
pcrVenus	VenusDel	376	5753	17	0	17	0.00295498	0	0.00295498	5736	0.99704502
pcrVenus	VenusDel	377	5753	16	2	18	0.0027811577	0.0003476447	0.0031288024	5737	0.9972188423
pcrVenus	VenusDel	378	5753	16	3	19	0.0027811577	0.0005214671	0.0033026247	5737	0.9972188423
pcrVenus	VenusDel	379	5753	16	3	19	0.0027811577	0.0005214671	0.0033026247	5737	0.9972188423
pcrVenus	VenusDel	380	5753	16	2	18	0.0027811577	0.0003476447	0.0031288024	5737	0.9972188423
pcrVenus	VenusDel	381	5753	16	5	21	0.0027811577	0.0008691118	0.0036502694	5737	0.9972188423
pcrVenus	VenusDel	382	5753	16	2	18	0.0027811577	0.0003476447	0.0031288024	5737	0.9972188423
pcrVenus	VenusDel	383	5753	16	1	17	0.0027811577	0.0001738224	0.00295498	5737	0.9972188423
pcrVenus	VenusDel	384	5753	17	1	18	0.00295498	0.0001738224	0.0031288024	5736	0.99704502
pcrVenus	VenusDel	385	5753	16	0	16	0.0027811577	0	0.0027811577	5737	0.9972188423
pcrVenus	VenusDel	386	5753	16	0	16	0.0027811577	0	0.0027811577	5737	0.9972188423
pcrVenus	VenusDel	387	5753	16	6	22	0.0027811577	0.0010429341	0.0038240918	5737	0.9972188423
pcrVenus	VenusDel	388	5753	16	0	16	0.0027811577	0	0.0027811577	5737	0.9972188423
pcrVenus	VenusDel	389	5753	16	1	17	0.0027811577	0.0001738224	0.00295498	5737	0.9972188423
pcrVenus	VenusDel	390	5753	20	1	21	0.0034764471	0.0001738224	0.0036502694	5733	0.9965235529
pcrVenus	VenusDel	391	5753	16	0	16	0.0027811577	0	0.0027811577	5737	0.9972188423
pcrVenus	VenusDel	392	5753	16	2	18	0.0027811577	0.0003476447	0.0031288024	5737	0.9972188423
pcrVenus	VenusDel	393	5753	16	1	17	0.0027811577	0.0001738224	0.00295498	5737	0.9972188423
pcrVenus	VenusDel	394	5753	23	2	25	0.0039979141	0.0003476447	0.0043455588	5730	0.9960020859
pcrVenus	VenusDel	395	5753	16	0	16	0.0027811577	0	0.0027811577	5737	0.9972188423
pcrVenus	VenusDel	396	5753	16	0	16	0.0027811577	0	0.0027811577	5737	0.9972188423
pcrVenus	VenusDel	397	5753	20	6	26	0.0034764471	0.0010429341	0.0045193812	5733	0.9965235529
pcrVenus	VenusDel	398	5753	16	0	16	0.0027811577	0	0.0027811577	5737	0.9972188423
pcrVenus	VenusDel	399	5753	16	1	17	0.0027811577	0.0001738224	0.00295498	5737	0.9972188423
pcrVenus	VenusDel	400	5753	16	0	16	0.0027811577	0	0.0027811577	5737	0.9972188423
pcrVenus	VenusDel	401	5753	16	1	17	0.0027811577	0.0001738224	0.00295498	5737	0.9972188423
pcrVenus	VenusDel	402	5753	67	4	71	0.0116460977	0.0006952894	0.0123413871	5686	0.9883539023
pcrVenus	VenusDel	403	5753	16	0	16	0.0027811577	0	0.0027811577	5737	0.9972188423
pcrVenus	VenusDel	404	5753	16	0	16	0.0027811577	0	0.0027811577	5737	0.9972188423
pcrVenus	VenusDel	405	5753	16	3	19	0.0027811577	0.0005214671	0.0033026247	5737	0.9972188423
pcrVenus	VenusDel	406	5753	16	1	17	0.0027811577	0.0001738224	0.00295498	5737	0.9972188423
pcrVenus	VenusDel	407	5753	16	0	16	0.0027811577	0	0.0027811577	5737	0.9972188423
pcrVenus	VenusDel	408	5753	17	3	20	0.00295498	0.0005214671	0.0034764471	5736	0.99704502
pcrVenus	VenusDel	409	5753	16	0	16	0.0027811577	0	0.0027811577	5737	0.9972188423
pcrVenus	VenusDel	410	5753	16	0	16	0.0027811577	0	0.0027811577	5737	0.9972188423
pcrVenus	VenusDel	411	5753	16	2	18	0.0027811577	0.0003476447	0.0031288024	5737	0.9972188423
pcrVenus	VenusDel	412	5753	16	0	16	0.0027811577	0	0.0027811577	5737	0.9972188423
pcrVenus	VenusDel	413	5753	16	3	19	0.0027811577	0.0005214671	0.0033026247	5737	0.9972188423
pcrVenus	VenusDel	414	5753	16	0	16	0.0027811577	0	0.0027811577	5737	0.9972188423
pcrVenus	VenusDel	415	5753	16	0	16	0.0027811577	0	0.0027811577	5737	0.9972188423
pcrVenus	VenusDel	416	5753	19	7	26	0.0033026247	0.0012167565	0.0045193812	5734	0.9966973753
pcrVenus	VenusDel	417	5753	16	0	16	0.0027811577	0	0.0027811577	5737	0.9972188423
pcrVenus	VenusDel	418	5753	16	1	17	0.0027811577	0.0001738224	0.00295498	5737	0.9972188423
pcrVenus	VenusDel	419	5753	17	1	18	0.00295498	0.0001738224	0.0031288024	5736	0.99704502
pcrVenus	VenusDel	420	5753	16	0	16	0.0027811577	0	0.0027811577	5737	0.9972188423
pcrVenus	VenusDel	421	5753	16	0	16	0.0027811577	0	0.0027811577	5737	0.9972188423
pcrVenus	VenusDel	422	5753	16	1	17	0.0027811577	0.0001738224	0.00295498	5737	0.9972188423
pcrVenus	VenusDel	423	5753	16	2	18	0.0027811577	0.0003476447	0.0031288024	5737	0.9972188423
pcrVenus	VenusDel	424	5753	16	0	16	0.0027811577	0	0.0027811577	5737	0.9972188423
pcrVenus	VenusDel	425	5753	16	3	19	0.0027811577	0.0005214671	0.0033026247	5737	0.9972188423
pcrVenus	VenusDel	426	5753	16	2	18	0.0027811577	0.0003476447	0.0031288024	5737	0.9972188423
pcrVenus	VenusDel	427	5753	17	3	20	0.00295498	0.0005214671	0.0034764471	5736	0.99704502
pcrVenus	VenusDel	428	5753	16	0	16	0.0027811577	0	0.0027811577	5737	0.9972188423
pcrVenus	VenusDel	429	5753	16	4	20	0.0027811577	0.0006952894	0.0034764471	5737	0.9972188423
pcrVenus	VenusDel	430	5753	16	0	16	0.0027811577	0	0.0027811577	5737	0.9972188423
pcrVenus	VenusDel	431	5753	17	0	17	0.00295498	0	0.00295498	5736	0.99704502
pcrVenus	VenusDel	432	5753	22	3	25	0.0038240918	0.0005214671	0.0043455588	5731	0.9961759082
pcrVenus	VenusDel	433	5753	16	2	18	0.0027811577	0.0003476447	0.0031288024	5737	0.9972188423
pcrVenus	VenusDel	434	5753	16	0	16	0.0027811577	0	0.0027811577	5737	0.9972188423
pcrVenus	VenusDel	435	5753	17	2	19	0.00295498	0.0003476447	0.0033026247	5736	0.99704502
pcrVenus	VenusDel	436	5753	17	1	18	0.00295498	0.0001738224	0.0031288024	5736	0.99704502
pcrVenus	VenusDel	437	5753	17	0	17	0.00295498	0	0.00295498	5736	0.99704502
pcrVenus	VenusDel	438	5753	20	2	22	0.0034764471	0.0003476447	0.0038240918	5733	0.9965235529
pcrVenus	VenusDel	439	5753	16	0	16	0.0027811577	0	0.0027811577	5737	0.9972188423
pcrVenus	VenusDel	440	5753	21	5	26	0.0036502694	0.0008691118	0.0045193812	5732	0.9963497306
pcrVenus	VenusDel	441	5753	16	0	16	0.0027811577	0	0.0027811577	5737	0.9972188423
pcrVenus	VenusDel	442	5753	17	1	18	0.00295498	0.0001738224	0.0031288024	5736	0.99704502
pcrVenus	VenusDel	443	5753	16	1	17	0.0027811577	0.0001738224	0.00295498	5737	0.9972188423
pcrVenus	VenusDel	444	5753	16	1	17	0.0027811577	0.0001738224	0.00295498	5737	0.9972188423
pcrVenus	VenusDel	445	5753	16	0	16	0.0027811577	0	0.0027811577	5737	0.9972188423
pcrVenus	VenusDel	446	5753	16	1	17	0.0027811577	0.0001738224	0.00295498	5737	0.9972188423
pcrVenus	VenusDel	447	5753	17	6	23	0.00295498	0.0010429341	0.0039979141	5736	0.99704502
pcrVenus	VenusDel	448	5753	16	0	16	0.0027811577	0	0.0027811577	5737	0.9972188423
pcrVenus	VenusDel	449	5753	16	1	17	0.0027811577	0.0001738224	0.00295498	5737	0.9972188423
pcrVenus	VenusDel	450	5753	27	1	28	0.0046932035	0.0001738224	0.0048670259	5726	0.9953067965
pcrVenus	VenusDel	451	5753	16	0	16	0.0027811577	0	0.0027811577	5737	0.9972188423
pcrVenus	VenusDel	452	5753	12	27	39	0.0020858682	0.0046932035	0.0067790718	5741	0.9979141318
pcrVenus	VenusDel	453	5753	12	2	14	0.0020858682	0.0003476447	0.0024335129	5741	0.9979141318
pcrVenus	VenusDel	454	5753	12	0	12	0.0020858682	0	0.0020858682	5741	0.9979141318
pcrVenus	VenusDel	455	5753	12	0	12	0.0020858682	0	0.0020858682	5741	0.9979141318
pcrVenus	VenusDel	456	5753	19	2	21	0.0033026247	0.0003476447	0.0036502694	5734	0.9966973753
pcrVenus	VenusDel	457	5753	12	0	12	0.0020858682	0	0.0020858682	5741	0.9979141318
pcrVenus	VenusDel	458	5753	12	1	13	0.0020858682	0.0001738224	0.0022596906	5741	0.9979141318
pcrVenus	VenusDel	459	5753	12	1	13	0.0020858682	0.0001738224	0.0022596906	5741	0.9979141318
pcrVenus	VenusDel	460	5753	27	14	41	0.0046932035	0.0024335129	0.0071267165	5726	0.9953067965
pcrVenus	VenusDel	461	5753	12	0	12	0.0020858682	0	0.0020858682	5741	0.9979141318
pcrVenus	VenusDel	462	5753	12	0	12	0.0020858682	0	0.0020858682	5741	0.9979141318
pcrVenus	VenusDel	463	5753	13	1	14	0.0022596906	0.0001738224	0.0024335129	5740	0.9977403094
pcrVenus	VenusDel	464	5753	12	3	15	0.0020858682	0.0005214671	0.0026073353	5741	0.9979141318
pcrVenus	VenusDel	465	5753	14	0	14	0.0024335129	0	0.0024335129	5739	0.9975664871
pcrVenus	VenusDel	466	5753	18	1	19	0.0031288024	0.0001738224	0.0033026247	5735	0.9968711976
pcrVenus	VenusDel	467	5753	12	0	12	0.0020858682	0	0.0020858682	5741	0.9979141318
pcrVenus	VenusDel	468	5753	12	1	13	0.0020858682	0.0001738224	0.0022596906	5741	0.9979141318
pcrVenus	VenusDel	469	5753	12	1	13	0.0020858682	0.0001738224	0.0022596906	5741	0.9979141318
pcrVenus	VenusDel	470	5753	15	2	17	0.0026073353	0.0003476447	0.00295498	5738	0.9973926647
pcrVenus	VenusDel	471	5753	12	0	12	0.0020858682	0	0.0020858682	5741	0.9979141318
pcrVenus	VenusDel	472	5753	12	1	13	0.0020858682	0.0001738224	0.0022596906	5741	0.9979141318
pcrVenus	VenusDel	473	5753	12	2	14	0.0020858682	0.0003476447	0.0024335129	5741	0.9979141318
pcrVenus	VenusDel	474	5753	14	2	16	0.0024335129	0.0003476447	0.0027811577	5739	0.9975664871
pcrVenus	VenusDel	475	5753	12	0	12	0.0020858682	0	0.0020858682	5741	0.9979141318
pcrVenus	VenusDel	476	5753	12	1	13	0.0020858682	0.0001738224	0.0022596906	5741	0.9979141318
pcrVenus	VenusDel	477	5753	14	4	18	0.0024335129	0.0006952894	0.0031288024	5739	0.9975664871
pcrVenus	VenusDel	478	5753	12	0	12	0.0020858682	0	0.0020858682	5741	0.9979141318
pcrVenus	VenusDel	479	5753	12	4	16	0.0020858682	0.0006952894	0.0027811577	5741	0.9979141318
pcrVenus	VenusDel	480	5753	12	3	15	0.0020858682	0.0005214671	0.0026073353	5741	0.9979141318
pcrVenus	VenusDel	481	5753	12	1	13	0.0020858682	0.0001738224	0.0022596906	5741	0.9979141318
pcrVenus	VenusDel	482	5753	33	8	41	0.0057361377	0.0013905788	0.0071267165	5720	0.9942638623
pcrVenus	VenusDel	483	5753	12	0	12	0.0020858682	0	0.0020858682	5741	0.9979141318
pcrVenus	VenusDel	484	5753	12	0	12	0.0020858682	0	0.0020858682	5741	0.9979141318
pcrVenus	VenusDel	485	5753	12	0	12	0.0020858682	0	0.0020858682	5741	0.9979141318
pcrVenus	VenusDel	486	5753	12	2	14	0.0020858682	0.0003476447	0.0024335129	5741	0.9979141318
pcrVenus	VenusDel	487	5753	12	1	13	0.0020858682	0.0001738224	0.0022596906	5741	0.9979141318
pcrVenus	VenusDel	488	5753	12	3	15	0.0020858682	0.0005214671	0.0026073353	5741	0.9979141318
pcrVenus	VenusDel	489	5753	13	2	15	0.0022596906	0.0003476447	0.0026073353	5740	0.9977403094
pcrVenus	VenusDel	490	5753	23	25	48	0.0039979141	0.0043455588	0.008343473	5730	0.9960020859
pcrVenus	VenusDel	491	5753	12	0	12	0.0020858682	0	0.0020858682	5741	0.9979141318
pcrVenus	VenusDel	492	5753	12	0	12	0.0020858682	0	0.0020858682	5741	0.9979141318
pcrVenus	VenusDel	493	5753	12	0	12	0.0020858682	0	0.0020858682	5741	0.9979141318
pcrVenus	VenusDel	494	5753	13	5	18	0.0022596906	0.0008691118	0.0031288024	5740	0.9977403094
pcrVenus	VenusDel	495	5753	12	2	14	0.0020858682	0.0003476447	0.0024335129	5741	0.9979141318
pcrVenus	VenusDel	496	5753	12	1	13	0.0020858682	0.0001738224	0.0022596906	5741	0.9979141318
pcrVenus	VenusDel	497	5753	12	1	13	0.0020858682	0.0001738224	0.0022596906	5741	0.9979141318
pcrVenus	VenusDel	498	5753	15	10	25	0.0026073353	0.0017382235	0.0043455588	5738	0.9973926647
pcrVenus	VenusDel	499	5753	12	0	12	0.0020858682	0	0.0020858682	5741	0.9979141318
pcrVenus	VenusDel	500	5753	13	9	22	0.0022596906	0.0015644012	0.0038240918	5740	0.9977403094
pcrVenus	VenusDel	501	5753	12	0	12	0.0020858682	0	0.0020858682	5741	0.9979141318
pcrVenus	VenusDel	502	5753	12	2	14	0.0020858682	0.0003476447	0.0024335129	5741	0.9979141318
pcrVenus	VenusDel	503	5753	12	1	13	0.0020858682	0.0001738224	0.0022596906	5741	0.9979141318
pcrVenus	VenusDel	504	5753	12	5	17	0.0020858682	0.0008691118	0.00295498	5741	0.9979141318
pcrVenus	VenusDel	505	5753	12	0	12	0.0020858682	0	0.0020858682	5741	0.9979141318
pcrVenus	VenusDel	506	5753	12	2	14	0.0020858682	0.0003476447	0.0024335129	5741	0.9979141318
pcrVenus	VenusDel	507	5753	12	0	12	0.0020858682	0	0.0020858682	5741	0.9979141318
pcrVenus	VenusDel	508	5753	12	0	12	0.0020858682	0	0.0020858682	5741	0.9979141318
pcrVenus	VenusDel	509	5753	12	0	12	0.0020858682	0	0.0020858682	5741	0.9979141318
pcrVenus	VenusDel	510	5753	12	0	12	0.0020858682	0	0.0020858682	5741	0.9979141318
pcrVenus	VenusDel	511	5753	12	0	12	0.0020858682	0	0.0020858682	5741	0.9979141318
pcrVenus	VenusDel	512	5753	12	0	12	0.0020858682	0	0.0020858682	5741	0.9979141318
pcrVenus	VenusDel	513	5753	13	5	18	0.0022596906	0.0008691118	0.0031288024	5740	0.9977403094
pcrVenus	VenusDel	514	5753	12	0	12	0.0020858682	0	0.0020858682	5741	0.9979141318
pcrVenus	VenusDel	515	5753	36	6	42	0.0062576047	0.0010429341	0.0073005388	5717	0.9937423953
pcrVenus	VenusDel	516	5753	12	0	12	0.0020858682	0	0.0020858682	5741	0.9979141318
pcrVenus	VenusDel	517	5753	11	0	11	0.0019120459	0	0.0019120459	5742	0.9980879541
pcrVenus	VenusDel	518	5753	11	1	12	0.0019120459	0.0001738224	0.0020858682	5742	0.9980879541
pcrVenus	VenusDel	519	5753	11	11	22	0.0019120459	0.0019120459	0.0038240918	5742	0.9980879541
pcrVenus	VenusDel	520	5753	11	2	13	0.0019120459	0.0003476447	0.0022596906	5742	0.9980879541
pcrVenus	VenusDel	521	5753	11	2	13	0.0019120459	0.0003476447	0.0022596906	5742	0.9980879541
pcrVenus	VenusDel	522	5753	11	1	12	0.0019120459	0.0001738224	0.0020858682	5742	0.9980879541
pcrVenus	VenusDel	523	5753	11	1	12	0.0019120459	0.0001738224	0.0020858682	5742	0.9980879541
pcrVenus	VenusDel	524	5753	11	0	11	0.0019120459	0	0.0019120459	5742	0.9980879541
pcrVenus	VenusDel	525	5753	15	0	15	0.0026073353	0	0.0026073353	5738	0.9973926647
pcrVenus	VenusDel	526	5753	11	0	11	0.0019120459	0	0.0019120459	5742	0.9980879541
pcrVenus	VenusDel	527	5753	11	1	12	0.0019120459	0.0001738224	0.0020858682	5742	0.9980879541
pcrVenus	VenusDel	528	5753	13	3	16	0.0022596906	0.0005214671	0.0027811577	5740	0.9977403094
pcrVenus	VenusDel	529	5753	8	0	8	0.0013905788	0	0.0013905788	5745	0.9986094212
pcrVenus	VenusDel	530	5753	12	3	15	0.0020858682	0.0005214671	0.0026073353	5741	0.9979141318
pcrVenus	VenusDel	531	5753	8	0	8	0.0013905788	0	0.0013905788	5745	0.9986094212
pcrVenus	VenusDel	532	5753	8	0	8	0.0013905788	0	0.0013905788	5745	0.9986094212
pcrVenus	VenusDel	533	5753	11	5	16	0.0019120459	0.0008691118	0.0027811577	5742	0.9980879541
pcrVenus	VenusDel	534	5753	8	0	8	0.0013905788	0	0.0013905788	5745	0.9986094212
pcrVenus	VenusDel	535	5753	8	0	8	0.0013905788	0	0.0013905788	5745	0.9986094212
pcrVenus	VenusDel	536	5753	8	0	8	0.0013905788	0	0.0013905788	5745	0.9986094212
pcrVenus	VenusDel	537	5753	9	11	20	0.0015644012	0.0019120459	0.0034764471	5744	0.9984355988
pcrVenus	VenusDel	538	5753	8	0	8	0.0013905788	0	0.0013905788	5745	0.9986094212
pcrVenus	VenusDel	539	5753	8	1	9	0.0013905788	0.0001738224	0.0015644012	5745	0.9986094212
pcrVenus	VenusDel	540	5753	10	9	19	0.0017382235	0.0015644012	0.0033026247	5743	0.9982617765
pcrVenus	VenusDel	541	5753	8	0	8	0.0013905788	0	0.0013905788	5745	0.9986094212
pcrVenus	VenusDel	542	5753	9	1	10	0.0015644012	0.0001738224	0.0017382235	5744	0.9984355988
pcrVenus	VenusDel	543	5753	8	0	8	0.0013905788	0	0.0013905788	5745	0.9986094212
pcrVenus	VenusDel	544	5753	8	0	8	0.0013905788	0	0.0013905788	5745	0.9986094212
pcrVenus	VenusDel	545	5753	9	2	11	0.0015644012	0.0003476447	0.0019120459	5744	0.9984355988
pcrVenus	VenusDel	546	5753	8	0	8	0.0013905788	0	0.0013905788	5745	0.9986094212
pcrVenus	VenusDel	547	5753	8	0	8	0.0013905788	0	0.0013905788	5745	0.9986094212
pcrVenus	VenusDel	548	5753	91	11	102	0.0158178342	0.0019120459	0.0177298801	5662	0.9841821658
pcrVenus	VenusDel	549	5753	8	0	8	0.0013905788	0	0.0013905788	5745	0.9986094212
pcrVenus	VenusDel	550	5753	8	1	9	0.0013905788	0.0001738224	0.0015644012	5745	0.9986094212
pcrVenus	VenusDel	551	5753	8	0	8	0.0013905788	0	0.0013905788	5745	0.9986094212
pcrVenus	VenusDel	552	5753	8	1	9	0.0013905788	0.0001738224	0.0015644012	5745	0.9986094212
pcrVenus	VenusDel	553	5753	8	3	11	0.0013905788	0.0005214671	0.0019120459	5745	0.9986094212
pcrVenus	VenusDel	554	5753	8	2	10	0.0013905788	0.0003476447	0.0017382235	5745	0.9986094212
pcrVenus	VenusDel	555	5753	16	2	18	0.0027811577	0.0003476447	0.0031288024	5737	0.9972188423
pcrVenus	VenusDel	556	5753	8	0	8	0.0013905788	0	0.0013905788	5745	0.9986094212
pcrVenus	VenusDel	557	5753	8	0	8	0.0013905788	0	0.0013905788	5745	0.9986094212
pcrVenus	VenusDel	558	5753	8	0	8	0.0013905788	0	0.0013905788	5745	0.9986094212
pcrVenus	VenusDel	559	5753	9	1	10	0.0015644012	0.0001738224	0.0017382235	5744	0.9984355988
pcrVenus	VenusDel	560	5753	9	9	18	0.0015644012	0.0015644012	0.0031288024	5744	0.9984355988
pcrVenus	VenusDel	561	5753	8	0	8	0.0013905788	0	0.0013905788	5745	0.9986094212
pcrVenus	VenusDel	562	5753	8	0	8	0.0013905788	0	0.0013905788	5745	0.9986094212
pcrVenus	VenusDel	563	5753	8	1	9	0.0013905788	0.0001738224	0.0015644012	5745	0.9986094212
pcrVenus	VenusDel	564	5753	8	1	9	0.0013905788	0.0001738224	0.0015644012	5745	0.9986094212
pcrVenus	VenusDel	565	5753	8	5	13	0.0013905788	0.0008691118	0.0022596906	5745	0.9986094212
pcrVenus	VenusDel	566	5753	9	1	10	0.0015644012	0.0001738224	0.0017382235	5744	0.9984355988
pcrVenus	VenusDel	567	5753	10	10	20	0.0017382235	0.0017382235	0.0034764471	5743	0.9982617765
pcrVenus	VenusDel	568	5753	8	0	8	0.0013905788	0	0.0013905788	5745	0.9986094212
pcrVenus	VenusDel	569	5753	8	0	8	0.0013905788	0	0.0013905788	5745	0.9986094212
pcrVenus	VenusDel	570	5753	8	10	18	0.0013905788	0.0017382235	0.0031288024	5745	0.9986094212
pcrVenus	VenusDel	571	5753	15	1	16	0.0026073353	0.0001738224	0.0027811577	5738	0.9973926647
pcrVenus	VenusDel	572	5753	8	3	11	0.0013905788	0.0005214671	0.0019120459	5745	0.9986094212
pcrVenus	VenusDel	573	5753	11	10	21	0.0019120459	0.0017382235	0.0036502694	5742	0.9980879541
pcrVenus	VenusDel	574	5753	8	0	8	0.0013905788	0	0.0013905788	5745	0.9986094212
pcrVenus	VenusDel	575	5753	8	2	10	0.0013905788	0.0003476447	0.0017382235	5745	0.9986094212
pcrVenus	VenusDel	576	5753	10	2	12	0.0017382235	0.0003476447	0.0020858682	5743	0.9982617765
pcrVenus	VenusDel	577	5753	8	1	9	0.0013905788	0.0001738224	0.0015644012	5745	0.9986094212
pcrVenus	VenusDel	578	5753	7	8	15	0.0012167565	0.0013905788	0.0026073353	5746	0.9987832435
pcrVenus	VenusDel	579	5753	7	0	7	0.0012167565	0	0.0012167565	5746	0.9987832435
pcrVenus	VenusDel	580	5753	8	1	9	0.0013905788	0.0001738224	0.0015644012	5745	0.9986094212
pcrVenus	VenusDel	581	5753	8	1	9	0.0013905788	0.0001738224	0.0015644012	5745	0.9986094212
pcrVenus	VenusDel	582	5753	13	11	24	0.0022596906	0.0019120459	0.0041717365	5740	0.9977403094
pcrVenus	VenusDel	583	5753	7	2	9	0.0012167565	0.0003476447	0.0015644012	5746	0.9987832435
pcrVenus	VenusDel	584	5753	8	0	8	0.0013905788	0	0.0013905788	5745	0.9986094212
pcrVenus	VenusDel	585	5753	8	8	16	0.0013905788	0.0013905788	0.0027811577	5745	0.9986094212
pcrVenus	VenusDel	586	5753	7	3	10	0.0012167565	0.0005214671	0.0017382235	5746	0.9987832435
pcrVenus	VenusDel	587	5753	7	4	11	0.0012167565	0.0006952894	0.0019120459	5746	0.9987832435
pcrVenus	VenusDel	588	5753	7	0	7	0.0012167565	0	0.0012167565	5746	0.9987832435
pcrVenus	VenusDel	589	5753	7	1	8	0.0012167565	0.0001738224	0.0013905788	5746	0.9987832435
pcrVenus	VenusDel	590	5753	7	1	8	0.0012167565	0.0001738224	0.0013905788	5746	0.9987832435
pcrVenus	VenusDel	591	5753	9	1	10	0.0015644012	0.0001738224	0.0017382235	5744	0.9984355988
pcrVenus	VenusDel	592	5753	9	2	11	0.0015644012	0.0003476447	0.0019120459	5744	0.9984355988
pcrVenus	VenusDel	593	5753	7	3	10	0.0012167565	0.0005214671	0.0017382235	5746	0.9987832435
pcrVenus	VenusDel	594	5753	7	2	9	0.0012167565	0.0003476447	0.0015644012	5746	0.9987832435
pcrVenus	VenusDel	595	5753	25	3	28	0.0043455588	0.0005214671	0.0048670259	5728	0.9956544412
pcrVenus	VenusDel	596	5753	7	10	17	0.0012167565	0.0017382235	0.00295498	5746	0.9987832435
pcrVenus	VenusDel	597	5753	7	39	46	0.0012167565	0.0067790718	0.0079958283	5746	0.9987832435
pcrVenus	VenusDel	598	5753	24	0	24	0.0041717365	0	0.0041717365	5729	0.9958282635
pcrVenus	VenusDel	599	5753	7	0	7	0.0012167565	0	0.0012167565	5746	0.9987832435
pcrVenus	VenusDel	600	5753	7	1	8	0.0012167565	0.0001738224	0.0013905788	5746	0.9987832435
pcrVenus	VenusDel	601	5753	7	4	11	0.0012167565	0.0006952894	0.0019120459	5746	0.9987832435
pcrVenus	VenusDel	602	5753	7	4	11	0.0012167565	0.0006952894	0.0019120459	5746	0.9987832435
pcrVenus	VenusDel	603	5753	12	3	15	0.0020858682	0.0005214671	0.0026073353	5741	0.9979141318
pcrVenus	VenusDel	604	5753	7	0	7	0.0012167565	0	0.0012167565	5746	0.9987832435
pcrVenus	VenusDel	605	5753	7	0	7	0.0012167565	0	0.0012167565	5746	0.9987832435
pcrVenus	VenusDel	606	5753	7	0	7	0.0012167565	0	0.0012167565	5746	0.9987832435
pcrVenus	VenusDel	607	5753	7	1	8	0.0012167565	0.0001738224	0.0013905788	5746	0.9987832435
pcrVenus	VenusDel	608	5753	7	0	7	0.0012167565	0	0.0012167565	5746	0.9987832435
pcrVenus	VenusDel	609	5753	9	18	27	0.0015644012	0.0031288024	0.0046932035	5744	0.9984355988
pcrVenus	VenusDel	610	5753	8	0	8	0.0013905788	0	0.0013905788	5745	0.9986094212
pcrVenus	VenusDel	611	5753	8	0	8	0.0013905788	0	0.0013905788	5745	0.9986094212
pcrVenus	VenusDel	612	5753	12	13	25	0.0020858682	0.0022596906	0.0043455588	5741	0.9979141318
pcrVenus	VenusDel	613	5753	7	2	9	0.0012167565	0.0003476447	0.0015644012	5746	0.9987832435
pcrVenus	VenusDel	614	5753	7	1	8	0.0012167565	0.0001738224	0.0013905788	5746	0.9987832435
pcrVenus	VenusDel	615	5753	13	5	18	0.0022596906	0.0008691118	0.0031288024	5740	0.9977403094
pcrVenus	VenusDel	616	5753	7	0	7	0.0012167565	0	0.0012167565	5746	0.9987832435
pcrVenus	VenusDel	617	5753	7	2	9	0.0012167565	0.0003476447	0.0015644012	5746	0.9987832435
pcrVenus	VenusDel	618	5753	7	2	9	0.0012167565	0.0003476447	0.0015644012	5746	0.9987832435
pcrVenus	VenusDel	619	5753	7	1	8	0.0012167565	0.0001738224	0.0013905788	5746	0.9987832435
pcrVenus	VenusDel	620	5753	7	1	8	0.0012167565	0.0001738224	0.0013905788	5746	0.9987832435
pcrVenus	VenusDel	621	5753	9	14	23	0.0015644012	0.0024335129	0.0039979141	5744	0.9984355988
pcrVenus	VenusDel	622	5753	7	0	7	0.0012167565	0	0.0012167565	5746	0.9987832435
pcrVenus	VenusDel	623	5753	9	6	15	0.0015644012	0.0010429341	0.0026073353	5744	0.9984355988
pcrVenus	VenusDel	624	5753	7	1	8	0.0012167565	0.0001738224	0.0013905788	5746	0.9987832435
pcrVenus	VenusDel	625	5753	16	13	29	0.0027811577	0.0022596906	0.0050408483	5737	0.9972188423
pcrVenus	VenusDel	626	5753	7	1	8	0.0012167565	0.0001738224	0.0013905788	5746	0.9987832435
pcrVenus	VenusDel	627	5753	10	5	15	0.0017382235	0.0008691118	0.0026073353	5743	0.9982617765
pcrVenus	VenusDel	628	5753	7	0	7	0.0012167565	0	0.0012167565	5746	0.9987832435
pcrVenus	VenusDel	629	5753	7	0	7	0.0012167565	0	0.0012167565	5746	0.9987832435
pcrVenus	VenusDel	630	5753	9	3	12	0.0015644012	0.0005214671	0.0020858682	5744	0.9984355988
pcrVenus	VenusDel	631	5753	7	0	7	0.0012167565	0	0.0012167565	5746	0.9987832435
pcrVenus	VenusDel	632	5753	7	4	11	0.0012167565	0.0006952894	0.0019120459	5746	0.9987832435
pcrVenus	VenusDel	633	5753	8	9	17	0.0013905788	0.0015644012	0.00295498	5745	0.9986094212
pcrVenus	VenusDel	634	5753	7	0	7	0.0012167565	0	0.0012167565	5746	0.9987832435
pcrVenus	VenusDel	635	5753	8	0	8	0.0013905788	0	0.0013905788	5745	0.9986094212
pcrVenus	VenusDel	636	5753	7	1	8	0.0012167565	0.0001738224	0.0013905788	5746	0.9987832435
pcrVenus	VenusDel	637	5753	7	1	8	0.0012167565	0.0001738224	0.0013905788	5746	0.9987832435
pcrVenus	VenusDel	638	5753	12	4	16	0.0020858682	0.0006952894	0.0027811577	5741	0.9979141318
pcrVenus	VenusDel	639	5753	7	0	7	0.0012167565	0	0.0012167565	5746	0.9987832435
pcrVenus	VenusDel	640	5753	8	0	8	0.0013905788	0	0.0013905788	5745	0.9986094212
pcrVenus	VenusDel	641	5753	8	9	17	0.0013905788	0.0015644012	0.00295498	5745	0.9986094212
pcrVenus	VenusDel	642	5753	7	1	8	0.0012167565	0.0001738224	0.0013905788	5746	0.9987832435
pcrVenus	VenusDel	643	5753	8	0	8	0.0013905788	0	0.0013905788	5745	0.9986094212
pcrVenus	VenusDel	644	5753	7	1	8	0.0012167565	0.0001738224	0.0013905788	5746	0.9987832435
pcrVenus	VenusDel	645	5753	10	11	21	0.0017382235	0.0019120459	0.0036502694	5743	0.9982617765
pcrVenus	VenusDel	646	5753	7	0	7	0.0012167565	0	0.0012167565	5746	0.9987832435
pcrVenus	VenusDel	647	5753	8	4	12	0.0013905788	0.0006952894	0.0020858682	5745	0.9986094212
pcrVenus	VenusDel	648	5753	7	1	8	0.0012167565	0.0001738224	0.0013905788	5746	0.9987832435
pcrVenus	VenusDel	649	5753	7	3	10	0.0012167565	0.0005214671	0.0017382235	5746	0.9987832435
pcrVenus	VenusDel	650	5753	8	1	9	0.0013905788	0.0001738224	0.0015644012	5745	0.9986094212
pcrVenus	VenusDel	651	5753	7	26	33	0.0012167565	0.0045193812	0.0057361377	5746	0.9987832435
pcrVenus	VenusDel	652	5753	7	0	7	0.0012167565	0	0.0012167565	5746	0.9987832435
pcrVenus	VenusDel	653	5753	9	5	14	0.0015644012	0.0008691118	0.0024335129	5744	0.9984355988
pcrVenus	VenusDel	654	5753	7	0	7	0.0012167565	0	0.0012167565	5746	0.9987832435
pcrVenus	VenusDel	655	5753	7	1	8	0.0012167565	0.0001738224	0.0013905788	5746	0.9987832435
pcrVenus	VenusDel	656	5753	8	3	11	0.0013905788	0.0005214671	0.0019120459	5745	0.9986094212
pcrVenus	VenusDel	657	5753	10	6	16	0.0017382235	0.0010429341	0.0027811577	5743	0.9982617765
pcrVenus	VenusDel	658	5753	8	0	8	0.0013905788	0	0.0013905788	5745	0.9986094212
pcrVenus	VenusDel	659	5753	8	1	9	0.0013905788	0.0001738224	0.0015644012	5745	0.9986094212
pcrVenus	VenusDel	660	5753	7	20	27	0.0012167565	0.0034764471	0.0046932035	5746	0.9987832435
pcrVenus	VenusDel	661	5753	7	1	8	0.0012167565	0.0001738224	0.0013905788	5746	0.9987832435
pcrVenus	VenusDel	662	5753	7	3	10	0.0012167565	0.0005214671	0.0017382235	5746	0.9987832435
pcrVenus	VenusDel	663	5753	7	4	11	0.0012167565	0.0006952894	0.0019120459	5746	0.9987832435
pcrVenus	VenusDel	664	5753	7	3	10	0.0012167565	0.0005214671	0.0017382235	5746	0.9987832435
pcrVenus	VenusDel	665	5753	7	2	9	0.0012167565	0.0003476447	0.0015644012	5746	0.9987832435
pcrVenus	VenusDel	666	5753	7	2	9	0.0012167565	0.0003476447	0.0015644012	5746	0.9987832435
pcrVenus	VenusDel	667	5753	7	1	8	0.0012167565	0.0001738224	0.0013905788	5746	0.9987832435
pcrVenus	VenusDel	668	5753	7	2	9	0.0012167565	0.0003476447	0.0015644012	5746	0.9987832435
pcrVenus	VenusDel	669	5753	7	0	7	0.0012167565	0	0.0012167565	5746	0.9987832435
pcrVenus	VenusDel	670	5753	7	0	7	0.0012167565	0	0.0012167565	5746	0.9987832435
pcrVenus	VenusDel	671	5753	7	1	8	0.0012167565	0.0001738224	0.0013905788	5746	0.9987832435
pcrVenus	VenusDel	672	5753	7	1	8	0.0012167565	0.0001738224	0.0013905788	5746	0.9987832435
pcrVenus	VenusDel	673	5753	14	5	19	0.0024335129	0.0008691118	0.0033026247	5739	0.9975664871
pcrVenus	VenusDel	674	5753	7	0	7	0.0012167565	0	0.0012167565	5746	0.9987832435
pcrVenus	VenusDel	675	5753	7	3	10	0.0012167565	0.0005214671	0.0017382235	5746	0.9987832435
pcrVenus	VenusDel	676	5753	7	1	8	0.0012167565	0.0001738224	0.0013905788	5746	0.9987832435
pcrVenus	VenusDel	677	5753	7	10	17	0.0012167565	0.0017382235	0.00295498	5746	0.9987832435
pcrVenus	VenusDel	678	5753	7	0	7	0.0012167565	0	0.0012167565	5746	0.9987832435
pcrVenus	VenusDel	679	5753	7	5	12	0.0012167565	0.0008691118	0.0020858682	5746	0.9987832435
pcrVenus	VenusDel	680	5753	7	0	7	0.0012167565	0	0.0012167565	5746	0.9987832435
pcrVenus	VenusDel	681	5753	7	1	8	0.0012167565	0.0001738224	0.0013905788	5746	0.9987832435
pcrVenus	VenusDel	682	5753	7	2	9	0.0012167565	0.0003476447	0.0015644012	5746	0.9987832435
pcrVenus	VenusDel	683	5753	9	8	17	0.0015644012	0.0013905788	0.00295498	5744	0.9984355988
pcrVenus	VenusDel	684	5753	7	0	7	0.0012167565	0	0.0012167565	5746	0.9987832435
pcrVenus	VenusDel	685	5753	7	1	8	0.0012167565	0.0001738224	0.0013905788	5746	0.9987832435
pcrVenus	VenusDel	686	5753	7	2	9	0.0012167565	0.0003476447	0.0015644012	5746	0.9987832435
pcrVenus	VenusDel	687	5753	8	0	8	0.0013905788	0	0.0013905788	5745	0.9986094212
pcrVenus	VenusDel	688	5753	7	1	8	0.0012167565	0.0001738224	0.0013905788	5746	0.9987832435
pcrVenus	VenusDel	689	5753	8	0	8	0.0013905788	0	0.0013905788	5745	0.9986094212
pcrVenus	VenusDel	690	5753	8	14	22	0.0013905788	0.0024335129	0.0038240918	5745	0.9986094212
pcrVenus	VenusDel	691	5753	7	0	7	0.0012167565	0	0.0012167565	5746	0.9987832435
pcrVenus	VenusDel	692	5753	8	1	9	0.0013905788	0.0001738224	0.0015644012	5745	0.9986094212
pcrVenus	VenusDel	693	5753	8	0	8	0.0013905788	0	0.0013905788	5745	0.9986094212
pcrVenus	VenusDel	694	5753	230	26	256	0.0399791413	0.0045193812	0.0444985225	5523	0.9600208587
pcrVenus	VenusDel	695	5753	7	0	7	0.0012167565	0	0.0012167565	5746	0.9987832435
pcrVenus	VenusDel	696	5753	7	0	7	0.0012167565	0	0.0012167565	5746	0.9987832435
pcrVenus	VenusDel	697	5753	7	0	7	0.0012167565	0	0.0012167565	5746	0.9987832435
pcrVenus	VenusDel	698	5753	7	0	7	0.0012167565	0	0.0012167565	5746	0.9987832435
pcrVenus	VenusDel	699	5753	7	0	7	0.0012167565	0	0.0012167565	5746	0.9987832435
pcrVenus	VenusDel	700	5753	7	1	8	0.0012167565	0.0001738224	0.0013905788	5746	0.9987832435
pcrVenus	VenusDel	701	5753	7	4	11	0.0012167565	0.0006952894	0.0019120459	5746	0.9987832435
pcrVenus	VenusDel	702	5753	16	1	17	0.0027811577	0.0001738224	0.00295498	5737	0.9972188423
pcrVenus	VenusDel	703	5753	7	0	7	0.0012167565	0	0.0012167565	5746	0.9987832435
pcrVenus	VenusDel	704	5753	7	0	7	0.0012167565	0	0.0012167565	5746	0.9987832435
pcrVenus	VenusDel	705	5753	7	3	10	0.0012167565	0.0005214671	0.0017382235	5746	0.9987832435
pcrVenus	VenusDel	706	5753	8	0	8	0.0013905788	0	0.0013905788	5745	0.9986094212
pcrVenus	VenusDel	707	5753	7	1	8	0.0012167565	0.0001738224	0.0013905788	5746	0.9987832435
pcrVenus	VenusDel	708	5753	9	8	17	0.0015644012	0.0013905788	0.00295498	5744	0.9984355988
pcrVenus	VenusDel	709	5753	7	0	7	0.0012167565	0	0.0012167565	5746	0.9987832435
pcrVenus	VenusDel	710	5753	54	32	86	0.0093864071	0.0055623153	0.0149487224	5699	0.9906135929
pcrVenus	VenusDel	711	5753	7	0	7	0.0012167565	0	0.0012167565	5746	0.9987832435
pcrVenus	VenusDel	712	5753	7	0	7	0.0012167565	0	0.0012167565	5746	0.9987832435
pcrVenus	VenusDel	713	5753	7	0	7	0.0012167565	0	0.0012167565	5746	0.9987832435
pcrVenus	VenusDel	714	5753	7	0	7	0.0012167565	0	0.0012167565	5746	0.9987832435
pcrVenus	VenusDel	715	5753	7	1	8	0.0012167565	0.0001738224	0.0013905788	5746	0.9987832435
pcrVenus	VenusDel	716	5753	7	2	9	0.0012167565	0.0003476447	0.0015644012	5746	0.9987832435
pcrVenus	VenusDel	717	5753	8	0	8	0.0013905788	0	0.0013905788	5745	0.9986094212
pcrVenus	VenusDel	718	5753	8	1	9	0.0013905788	0.0001738224	0.0015644012	5745	0.9986094212
pcrVenus	VenusDel	719	5753	7	3	10	0.0012167565	0.0005214671	0.0017382235	5746	0.9987832435
pcrVenus	VenusDel	720	5753	7	3	10	0.0012167565	0.0005214671	0.0017382235	5746	0.9987832435
pcrVenus	VenusDel	721	5753	7	2	9	0.0012167565	0.0003476447	0.0015644012	5746	0.9987832435
pcrVenus	VenusDel	722	5753	7	4	11	0.0012167565	0.0006952894	0.0019120459	5746	0.9987832435
pcrVenus	VenusDel	723	5753	29	16	45	0.0050408483	0.0027811577	0.0078220059	5724	0.9949591517
pcrVenus	VenusDel	724	5753	7	0	7	0.0012167565	0	0.0012167565	5746	0.9987832435
pcrVenus	VenusDel	725	5753	7	0	7	0.0012167565	0	0.0012167565	5746	0.9987832435
pcrVenus	VenusDel	726	5753	7	1	8	0.0012167565	0.0001738224	0.0013905788	5746	0.9987832435
pcrVenus	VenusDel	727	5753	8	2	10	0.0013905788	0.0003476447	0.0017382235	5745	0.9986094212
pcrVenus	VenusDel	728	5753	8	0	8	0.0013905788	0	0.0013905788	5745	0.9986094212
pcrVenus	VenusDel	729	5753	12	4	16	0.0020858682	0.0006952894	0.0027811577	5741	0.9979141318
pcrVenus	VenusDel	730	5753	7	0	7	0.0012167565	0	0.0012167565	5746	0.9987832435
pcrVenus	VenusDel	731	5753	12	14	26	0.0020858682	0.0024335129	0.0045193812	5741	0.9979141318
pcrVenus	VenusDel	732	5753	7	0	7	0.0012167565	0	0.0012167565	5746	0.9987832435
pcrVenus	VenusDel	733	5753	7	0	7	0.0012167565	0	0.0012167565	5746	0.9987832435
pcrVenus	VenusDel	734	5753	0	1	1	0	0.0001738224	0.0001738224	5753	1
pcrVenus	VenusDel	735	5753	0	1	1	0	0.0001738224	0.0001738224	5753	1
pcrVenus	VenusDel	736	5753	0	1	1	0	0.0001738224	0.0001738224	5753	1
pcrVenus	VenusDel	737	5753	5	1	6	0.0008691118	0.0001738224	0.0010429341	5748	0.9991308882
pcrVenus	VenusDel	738	5753	0	0	0	0	0	0	5753	1
pcrVenus	VenusDel	739	5753	0	1	1	0	0.0001738224	0.0001738224	5753	1
pcrVenus	VenusDel	740	5753	0	0	0	0	0	0	5753	1
pcrVenus	VenusDel	741	5753	0	4	4	0	0.0006952894	0.0006952894	5753	1
pcrVenus	VenusDel	742	5753	0	3	3	0	0.0005214671	0.0005214671	5753	1
pcrVenus	VenusDel	743	5753	0	1	1	0	0.0001738224	0.0001738224	5753	1
pcrVenus	VenusDel	744	5753	4	0	4	0.0006952894	0	0.0006952894	5749	0.9993047106
pcrVenus	VenusDel	745	5753	0	3	3	0	0.0005214671	0.0005214671	5753	1
pcrVenus	VenusDel	746	5753	4	47	51	0.0006952894	0.0081696506	0.00886494	5749	0.9993047106
pcrVenus	VenusDel	747	5753	0	0	0	0	0	0	5753	1
pcrVenus	VenusDel	748	5753	0	1	1	0	0.0001738224	0.0001738224	5753	1
pcrVenus	VenusDel	749	5753	0	1	1	0	0.0001738224	0.0001738224	5753	1
pcrVenus	VenusDel	750	5753	0	3	3	0	0.0005214671	0.0005214671	5753	1
pcrVenus	VenusDel	751	5753	2	12	14	0.0003476447	0.0020858682	0.0024335129	5751	0.9996523553
pcrVenus	VenusDel	752	5753	0	0	0	0	0	0	5753	1
pcrVenus	VenusDel	753	5753	0	2	2	0	0.0003476447	0.0003476447	5753	1
pcrVenus	VenusDel	754	5753	32	15	47	0.0055623153	0.0026073353	0.0081696506	5721	0.9944376847
pcrVenus	VenusDel	755	5753	0	0	0	0	0	0	5753	1
pcrVenus	VenusDel	756	5753	0	2	2	0	0.0003476447	0.0003476447	5753	1
pcrVenus	VenusDel	757	5753	1	1	2	0.0001738224	0.0001738224	0.0003476447	5752	0.9998261776
pcrVenus	VenusDel	758	5753	0	3	3	0	0.0005214671	0.0005214671	5753	1
pcrVenus	VenusDel	759	5753	1	0	1	0.0001738224	0	0.0001738224	5752	0.9998261776
pcrVenus	VenusDel	760	5753	1	1	2	0.0001738224	0.0001738224	0.0003476447	5752	0.9998261776
pcrVenus	VenusDel	761	5753	0	5	5	0	0.0008691118	0.0008691118	5753	1
pcrVenus	VenusDel	762	5753	13	9	22	0.0022596906	0.0015644012	0.0038240918	5740	0.9977403094
pcrVenus	VenusDel	763	5753	0	0	0	0	0	0	5753	1
pcrVenus	VenusDel	764	5753	0	1	1	0	0.0001738224	0.0001738224	5753	1
pcrVenus	VenusDel	765	5753	0	4	4	0	0.0006952894	0.0006952894	5753	1
pcrVenus	VenusDel	766	5753	0	0	0	0	0	0	5753	1
pcrVenus	VenusDel	767	5753	39	21	60	0.0067790718	0.0036502694	0.0104293412	5714	0.9932209282
pcrVenus	VenusDel	768	5753	0	1	1	0	0.0001738224	0.0001738224	5753	1
pcrVenus	VenusDel	769	5753	0	0	0	0	0	0	5753	1
pcrVenus	VenusDel	770	5753	0	0	0	0	0	0	5753	1
pcrVenus	VenusDel	771	5753	4	1	5	0.0006952894	0.0001738224	0.0008691118	5749	0.9993047106
pcrVenus	VenusDel	772	5753	0	0	0	0	0	0	5753	1
pcrVenus	VenusDel	773	5753	0	0	0	0	0	0	5753	1
pcrVenus	VenusDel	774	5753	0	2	2	0	0.0003476447	0.0003476447	5753	1
pcrVenus	VenusDel	775	5753	0	0	0	0	0	0	5753	1
pcrVenus	VenusDel	776	5753	1	0	1	0.0001738224	0	0.0001738224	5752	0.9998261776
pcrVenus	VenusDel	777	5753	1	7	8	0.0001738224	0.0012167565	0.0013905788	5752	0.9998261776
pcrVenus	VenusDel	778	5753	0	0	0	0	0	0	5753	1
pcrVenus	VenusDel	779	5753	0	2	2	0	0.0003476447	0.0003476447	5753	1
pcrVenus	VenusDel	780	5753	0	3	3	0	0.0005214671	0.0005214671	5753	1
pcrVenus	VenusDel	781	5753	1	3	4	0.0001738224	0.0005214671	0.0006952894	5752	0.9998261776
pcrVenus	VenusDel	782	5753	0	2	2	0	0.0003476447	0.0003476447	5753	1
pcrVenus	VenusDel	783	5753	0	4	4	0	0.0006952894	0.0006952894	5753	1
pcrVenus	VenusDel	784	5753	0	4	4	0	0.0006952894	0.0006952894	5753	1
pcrVenus	VenusDel	785	5753	0	3	3	0	0.0005214671	0.0005214671	5753	1
pcrVenus	VenusDel	786	5753	0	1	1	0	0.0001738224	0.0001738224	5753	1
pcrVenus	VenusDel	787	5753	0	5	5	0	0.0008691118	0.0008691118	5753	1
pcrVenus	VenusDel	788	5753	0	3	3	0	0.0005214671	0.0005214671	5753	1
pcrVenus	VenusDel	789	5753	1	3	4	0.0001738224	0.0005214671	0.0006952894	5752	0.9998261776
pcrVenus	VenusDel	790	5753	0	0	0	0	0	0	5753	1
pcrVenus	VenusDel	791	5753	14	3	17	0.0024335129	0.0005214671	0.00295498	5739	0.9975664871
pcrVenus	VenusDel	792	5753	0	1	1	0	0.0001738224	0.0001738224	5753	1
pcrVenus	VenusDel	793	5753	0	4	4	0	0.0006952894	0.0006952894	5753	1
pcrVenus	VenusDel	794	5753	3	5	8	0.0005214671	0.0008691118	0.0013905788	5750	0.9994785329
pcrVenus	VenusDel	795	5753	0	0	0	0	0	0	5753	1
pcrVenus	VenusDel	796	5753	0	1	1	0	0.0001738224	0.0001738224	5753	1
pcrVenus	VenusDel	797	5753	0	1	1	0	0.0001738224	0.0001738224	5753	1
pcrVenus	VenusDel	798	5753	0	0	0	0	0	0	5753	1
pcrVenus	VenusDel	799	5753	0	2	2	0	0.0003476447	0.0003476447	5753	1
pcrVenus	VenusDel	800	5753	1	4	5	0.0001738224	0.0006952894	0.0008691118	5752	0.9998261776
pcrVenus	VenusDel	801	5753	0	0	0	0	0	0	5753	1
pcrVenus	VenusDel	802	5753	0	1	1	0	0.0001738224	0.0001738224	5753	1
pcrVenus	VenusDel	803	5753	0	2	2	0	0.0003476447	0.0003476447	5753	1
pcrVenus	VenusDel	804	5753	0	14	14	0	0.0024335129	0.0024335129	5753	1
pcrVenus	VenusDel	805	5753	0	0	0	0	0	0	5753	1
pcrVenus	VenusDel	806	5753	0	11	11	0	0.0019120459	0.0019120459	5753	1
pcrVenus	VenusDel	807	5753	0	0	0	0	0	0	5753	1
pcrVenus	VenusDel	808	5753	2	2	4	0.0003476447	0.0003476447	0.0006952894	5751	0.9996523553
pcrVenus	VenusDel	809	5753	0	7	7	0	0.0012167565	0.0012167565	5753	1
pcrVenus	VenusDel	810	5753	0	3	3	0	0.0005214671	0.0005214671	5753	1
pcrVenus	VenusDel	811	5753	4	10	14	0.0006952894	0.0017382235	0.0024335129	5749	0.9993047106
pcrVenus	VenusDel	812	5753	0	0	0	0	0	0	5753	1
pcrVenus	VenusDel	813	5753	0	2	2	0	0.0003476447	0.0003476447	5753	1
pcrVenus	VenusDel	814	5753	4	3	7	0.0006952894	0.0005214671	0.0012167565	5749	0.9993047106
pcrVenus	VenusDel	815	5753	1	0	1	0.0001738224	0	0.0001738224	5752	0.9998261776
pcrVenus	VenusDel	816	5753	1	2	3	0.0001738224	0.0003476447	0.0005214671	5752	0.9998261776
pcrVenus	VenusDel	817	5753	8	6	14	0.0013905788	0.0010429341	0.0024335129	5745	0.9986094212
pcrVenus	VenusDel	818	5753	0	0	0	0	0	0	5753	1
pcrVenus	VenusDel	819	5753	42	8	50	0.0073005388	0.0013905788	0.0086911177	5711	0.9926994612
pcrVenus	VenusDel	820	5753	0	0	0	0	0	0	5753	1
pcrVenus	VenusDel	821	5753	0	0	0	0	0	0	5753	1
pcrVenus	VenusDel	822	5753	1	2	3	0.0001738224	0.0003476447	0.0005214671	5752	0.9998261776
pcrVenus	VenusDel	823	5753	0	1	1	0	0.0001738224	0.0001738224	5753	1
pcrVenus	VenusDel	824	5753	1	0	1	0.0001738224	0	0.0001738224	5752	0.9998261776
pcrVenus	VenusDel	825	5753	0	2	2	0	0.0003476447	0.0003476447	5753	1
pcrVenus	VenusDel	826	5753	0	0	0	0	0	0	5753	1
pcrVenus	VenusDel	827	5753	0	0	0	0	0	0	5753	1
pcrVenus	VenusDel	828	5753	0	1	1	0	0.0001738224	0.0001738224	5753	1
pcrVenus	VenusDel	829	5753	0	1	1	0	0.0001738224	0.0001738224	5753	1
pcrVenus	VenusDel	830	5753	0	1	1	0	0.0001738224	0.0001738224	5753	1
pcrVenus	VenusDel	831	5753	33	1	34	0.0057361377	0.0001738224	0.00590996	5720	0.9942638623
pcrVenus	VenusDel	832	5753	0	0	0	0	0	0	5753	1
pcrVenus	VenusDel	833	5753	0	3	3	0	0.0005214671	0.0005214671	5753	1
pcrVenus	VenusDel	834	5753	0	3	3	0	0.0005214671	0.0005214671	5753	1
pcrVenus	VenusDel	835	5753	0	0	0	0	0	0	5753	1
pcrVenus	VenusDel	836	5753	0	12	12	0	0.0020858682	0.0020858682	5753	1
pcrVenus	VenusDel	837	5753	0	0	0	0	0	0	5753	1
pcrVenus	VenusDel	838	5753	0	0	0	0	0	0	5753	1
pcrVenus	VenusDel	839	5753	0	0	0	0	0	0	5753	1
pcrVenus	VenusDel	840	5753	0	0	0	0	0	0	5753	1
pcrVenus	VenusDel	841	5753	0	0	0	0	0	0	5753	1
pcrVenus	VenusDel	842	5753	0	0	0	0	0	0	5753	1
pcrVenus	VenusDel	843	5753	0	4	4	0	0.0006952894	0.0006952894	5753	1
pcrVenus	VenusDel	844	5753	0	1	1	0	0.0001738224	0.0001738224	5753	1
pcrVenus	VenusDel	845	5753	0	1	1	0	0.0001738224	0.0001738224	5753	1
pcrVenus	VenusDel	846	5753	0	0	0	0	0	0	5753	1
pcrVenus	VenusDel	847	5753	0	1	1	0	0.0001738224	0.0001738224	5753	1
pcrVenus	VenusDel	848	5753	0	0	0	0	0	0	5753	1
pcrVenus	VenusDel	849	5753	4	4	8	0.0006952894	0.0006952894	0.0013905788	5749	0.9993047106
pcrVenus	VenusDel	850	5753	0	0	0	0	0	0	5753	1
pcrVenus	VenusDel	851	5753	0	0	0	0	0	0	5753	1
pcrVenus	VenusDel	852	5753	0	2	2	0	0.0003476447	0.0003476447	5753	1
pcrVenus	VenusDel	853	5753	0	13	13	0	0.0022596906	0.0022596906	5753	1
pcrVenus	VenusDel	854	5753	0	0	0	0	0	0	5753	1
pcrVenus	VenusDel	855	5753	0	2	2	0	0.0003476447	0.0003476447	5753	1
pcrVenus	VenusDel	856	5753	0	1	1	0	0.0001738224	0.0001738224	5753	1
pcrVenus	VenusDel	857	5753	0	1	1	0	0.0001738224	0.0001738224	5753	1
pcrVenus	VenusDel	858	5753	0	4	4	0	0.0006952894	0.0006952894	5753	1
pcrVenus	VenusDel	859	5753	0	2	2	0	0.0003476447	0.0003476447	5753	1
pcrVenus	VenusDel	860	5753	0	3	3	0	0.0005214671	0.0005214671	5753	1
pcrVenus	VenusDel	861	5753	3	2	5	0.0005214671	0.0003476447	0.0008691118	5750	0.9994785329
pcrVenus	VenusDel	862	5753	0	0	0	0	0	0	5753	1
pcrVenus	VenusDel	863	5753	3	2	5	0.0005214671	0.0003476447	0.0008691118	5750	0.9994785329
pcrVenus	VenusDel	864	5753	0	0	0	0	0	0	5753	1
pcrVenus	VenusDel	865	5753	0	0	0	0	0	0	5753	1
pcrVenus	VenusDel	866	5753	0	3	3	0	0.0005214671	0.0005214671	5753	1
pcrVenus	VenusDel	867	5753	3	4	7	0.0005214671	0.0006952894	0.0012167565	5750	0.9994785329
pcrVenus	VenusDel	868	5755	0	0	0	0	0	0	5755	1
pcrVenus	VenusDel	869	5755	6	2	8	0.0010425717	0.0003475239	0.0013900956	5749	0.9989574283
pcrVenus	VenusDel	870	5755	0	2	2	0	0.0003475239	0.0003475239	5755	1
pcrVenus	VenusDel	871	5755	0	1	1	0	0.0001737619	0.0001737619	5755	1
pcrVenus	VenusDel	872	5755	0	5	5	0	0.0008688097	0.0008688097	5755	1
pcrVenus	VenusDel	873	5755	0	0	0	0	0	0	5755	1
pcrVenus	VenusDel	874	5755	6	3	9	0.0010425717	0.0005212858	0.0015638575	5749	0.9989574283
pcrVenus	VenusDel	875	5755	0	0	0	0	0	0	5755	1
pcrVenus	VenusDel	876	5755	0	0	0	0	0	0	5755	1
pcrVenus	VenusDel	877	5755	0	4	4	0	0.0006950478	0.0006950478	5755	1
pcrVenus	VenusDel	878	5755	0	1	1	0	0.0001737619	0.0001737619	5755	1
pcrVenus	VenusDel	879	5755	0	0	0	0	0	0	5755	1
pcrVenus	VenusDel	880	5755	0	7	7	0	0.0012163336	0.0012163336	5755	1
pcrVenus	VenusDel	881	5755	0	1	1	0	0.0001737619	0.0001737619	5755	1
pcrVenus	VenusDel	882	5755	0	4	4	0	0.0006950478	0.0006950478	5755	1
pcrVenus	VenusDel	883	5755	1	5	6	0.0001737619	0.0008688097	0.0010425717	5754	0.9998262381
pcrVenus	VenusDel	884	5755	0	7	7	0	0.0012163336	0.0012163336	5755	1
pcrVenus	VenusDel	885	5755	1	5	6	0.0001737619	0.0008688097	0.0010425717	5754	0.9998262381
pcrVenus	VenusDel	886	5755	0	0	0	0	0	0	5755	1
pcrVenus	VenusDel	887	5755	0	0	0	0	0	0	5755	1
pcrVenus	VenusDel	888	5755	1	2	3	0.0001737619	0.0003475239	0.0005212858	5754	0.9998262381
pcrVenus	VenusDel	889	5755	3	1	4	0.0005212858	0.0001737619	0.0006950478	5752	0.9994787142
pcrVenus	VenusDel	890	5755	0	0	0	0	0	0	5755	1
pcrVenus	VenusDel	891	5755	0	0	0	0	0	0	5755	1
pcrVenus	VenusDel	892	5755	1	0	1	0.0001737619	0	0.0001737619	5754	0.9998262381
pcrVenus	VenusDel	893	5755	3	5	8	0.0005212858	0.0008688097	0.0013900956	5752	0.9994787142
pcrVenus	VenusDel	894	5755	0	0	0	0	0	0	5755	1
pcrVenus	VenusDel	895	5755	12	1	13	0.0020851434	0.0001737619	0.0022589053	5743	0.9979148566
pcrVenus	VenusDel	896	5755	0	0	0	0	0	0	5755	1
pcrVenus	VenusDel	897	5755	0	0	0	0	0	0	5755	1
pcrVenus	VenusDel	898	5755	6	4	10	0.0010425717	0.0006950478	0.0017376195	5749	0.9989574283
pcrVenus	VenusDel	899	5755	0	1	1	0	0.0001737619	0.0001737619	5755	1
pcrVenus	VenusDel	900	5755	1	0	1	0.0001737619	0	0.0001737619	5754	0.9998262381
pcrVenus	VenusDel	901	5755	4	5	9	0.0006950478	0.0008688097	0.0015638575	5751	0.9993049522
pcrVenus	VenusDel	902	5755	0	0	0	0	0	0	5755	1
pcrVenus	VenusDel	903	5755	1	0	1	0.0001737619	0	0.0001737619	5754	0.9998262381
pcrVenus	VenusDel	904	5755	0	1	1	0	0.0001737619	0.0001737619	5755	1
pcrVenus	VenusDel	905	5755	4	8	12	0.0006950478	0.0013900956	0.0020851434	5751	0.9993049522
pcrVenus	VenusDel	906	5755	1	0	1	0.0001737619	0	0.0001737619	5754	0.9998262381
pcrVenus	VenusDel	907	5755	1	3	4	0.0001737619	0.0005212858	0.0006950478	5754	0.9998262381
pcrVenus	VenusDel	908	5755	0	5	5	0	0.0008688097	0.0008688097	5755	1
pcrVenus	VenusDel	909	5755	0	0	0	0	0	0	5755	1
pcrVenus	VenusDel	910	5755	5	6	11	0.0008688097	0.0010425717	0.0019113814	5750	0.9991311903
pcrVenus	VenusDel	911	5755	0	2	2	0	0.0003475239	0.0003475239	5755	1
pcrVenus	VenusDel	912	5755	3	13	16	0.0005212858	0.0022589053	0.0027801911	5752	0.9994787142
pcrVenus	VenusDel	913	5755	0	0	0	0	0	0	5755	1
pcrVenus	VenusDel	914	5755	1	3	4	0.0001737619	0.0005212858	0.0006950478	5754	0.9998262381
pcrVenus	VenusDel	915	5755	0	1	1	0	0.0001737619	0.0001737619	5755	1
pcrVenus	VenusDel	916	5755	0	3	3	0	0.0005212858	0.0005212858	5755	1
pcrVenus	VenusDel	917	5755	0	0	0	0	0	0	5755	1
pcrVenus	VenusDel	918	5755	11	12	23	0.0019113814	0.0020851434	0.0039965248	5744	0.9980886186
pcrVenus	VenusDel	919	5756	0	0	0	0	0	0	5756	1
pcrVenus	VenusDel	920	5760	0	2	2	0	0.0003472222	0.0003472222	5760	1
pcrVenus	VenusDel	921	5760	0	0	0	0	0	0	5760	1
pcrVenus	VenusDel	922	5760	0	5	5	0	0.0008680556	0.0008680556	5760	1
pcrVenus	VenusDel	923	5760	0	0	0	0	0	0	5760	1
pcrVenus	VenusDel	924	5760	2	0	2	0.0003472222	0	0.0003472222	5758	0.9996527778
pcrVenus	VenusDel	925	5760	0	0	0	0	0	0	5760	1
pcrVenus	VenusDel	926	5760	0	3	3	0	0.0005208333	0.0005208333	5760	1
pcrVenus	VenusDel	927	5760	0	1	1	0	0.0001736111	0.0001736111	5760	1
pcrVenus	VenusDel	928	5760	0	2	2	0	0.0003472222	0.0003472222	5760	1
pcrVenus	VenusDel	929	5760	22	6	28	0.0038194444	0.0010416667	0.0048611111	5738	0.9961805556
pcrVenus	VenusDel	930	5760	0	1	1	0	0.0001736111	0.0001736111	5760	1
pcrVenus	VenusDel	931	5760	0	0	0	0	0	0	5760	1
pcrVenus	VenusDel	932	5760	0	1	1	0	0.0001736111	0.0001736111	5760	1
pcrVenus	VenusDel	933	5760	0	2	2	0	0.0003472222	0.0003472222	5760	1
pcrVenus	VenusDel	934	5760	5	5	10	0.0008680556	0.0008680556	0.0017361111	5755	0.9991319444
pcrVenus	VenusDel	935	5760	0	0	0	0	0	0	5760	1
pcrVenus	VenusDel	936	5760	0	0	0	0	0	0	5760	1
pcrVenus	VenusDel	937	5760	1	5	6	0.0001736111	0.0008680556	0.0010416667	5759	0.9998263889
pcrVenus	VenusDel	938	5760	0	1	1	0	0.0001736111	0.0001736111	5760	1
pcrVenus	VenusDel	939	5760	0	4	4	0	0.0006944444	0.0006944444	5760	1
pcrVenus	VenusDel	940	5760	0	0	0	0	0	0	5760	1
pcrVenus	VenusDel	941	5760	0	2	2	0	0.0003472222	0.0003472222	5760	1
pcrVenus	VenusDel	942	5760	0	2	2	0	0.0003472222	0.0003472222	5760	1
pcrVenus	VenusDel	943	5760	1	4	5	0.0001736111	0.0006944444	0.0008680556	5759	0.9998263889
pcrVenus	VenusDel	944	5760	1	1	2	0.0001736111	0.0001736111	0.0003472222	5759	0.9998263889
pcrVenus	VenusDel	945	5760	108	32	140	0.01875	0.0055555556	0.0243055556	5652	0.98125
pcrVenus	VenusDel	946	5760	0	0	0	0	0	0	5760	1
pcrVenus	VenusDel	947	5760	0	1	1	0	0.0001736111	0.0001736111	5760	1
pcrVenus	VenusDel	948	5760	0	0	0	0	0	0	5760	1
pcrVenus	VenusDel	949	5760	0	0	0	0	0	0	5760	1
pcrVenus	VenusDel	950	5760	18	12	30	0.003125	0.0020833333	0.0052083333	5742	0.996875
pcrVenus	VenusDel	951	5760	0	0	0	0	0	0	5760	1
pcrVenus	VenusDel	952	5760	0	5	5	0	0.0008680556	0.0008680556	5760	1
pcrVenus	VenusDel	953	5760	0	1	1	0	0.0001736111	0.0001736111	5760	1
pcrVenus	VenusDel	954	5760	0	1	1	0	0.0001736111	0.0001736111	5760	1
pcrVenus	VenusDel	955	5760	1	4	5	0.0001736111	0.0006944444	0.0008680556	5759	0.9998263889
pcrVenus	VenusDel	956	5760	0	1	1	0	0.0001736111	0.0001736111	5760	1
pcrVenus	VenusDel	957	5760	3	19	22	0.0005208333	0.0032986111	0.0038194444	5757	0.9994791667
pcrVenus	VenusDel	958	5760	0	0	0	0	0	0	5760	1
pcrVenus	VenusDel	959	5760	198	22	220	0.034375	0.0038194444	0.0381944444	5562	0.965625
pcrVenus	VenusDel	960	5760	0	0	0	0	0	0	5760	1
pcrVenus	VenusDel	961	5760	0	0	0	0	0	0	5760	1
pcrVenus	VenusDel	962	5760	0	0	0	0	0	0	5760	1
pcrVenus	VenusDel	963	5760	1	0	1	0.0001736111	0	0.0001736111	5759	0.9998263889
pcrVenus	VenusDel	964	5760	6	1	7	0.0010416667	0.0001736111	0.0012152778	5754	0.9989583333
pcrVenus	VenusDel	965	5760	0	0	0	0	0	0	5760	1
pcrVenus	VenusDel	966	5760	0	1	1	0	0.0001736111	0.0001736111	5760	1
pcrVenus	VenusDel	967	5760	0	1	1	0	0.0001736111	0.0001736111	5760	1
pcrVenus	VenusDel	968	5760	137	12	149	0.0237847222	0.0020833333	0.0258680556	5623	0.9762152778
pcrVenus	VenusDel	969	5760	0	4	4	0	0.0006944444	0.0006944444	5760	1
pcrVenus	VenusDel	970	5760	0	0	0	0	0	0	5760	1
pcrVenus	VenusDel	971	5760	1	0	1	0.0001736111	0	0.0001736111	5759	0.9998263889
pcrVenus	VenusDel	972	5760	1	4	5	0.0001736111	0.0006944444	0.0008680556	5759	0.9998263889
pcrVenus	VenusDel	973	5760	0	1	1	0	0.0001736111	0.0001736111	5760	1
pcrVenus	VenusDel	974	5760	1	1	2	0.0001736111	0.0001736111	0.0003472222	5759	0.9998263889
pcrVenus	VenusDel	975	5760	0	1	1	0	0.0001736111	0.0001736111	5760	1
pcrVenus	VenusDel	976	5760	0	2	2	0	0.0003472222	0.0003472222	5760	1
pcrVenus	VenusDel	977	5760	0	8	8	0	0.0013888889	0.0013888889	5760	1
pcrVenus	VenusDel	978	5760	0	3	3	0	0.0005208333	0.0005208333	5760	1
pcrVenus	VenusDel	979	5760	0	6	6	0	0.0010416667	0.0010416667	5760	1
pcrVenus	VenusDel	980	5760	1	4	5	0.0001736111	0.0006944444	0.0008680556	5759	0.9998263889
pcrVenus	VenusDel	981	5760	1	0	1	0.0001736111	0	0.0001736111	5759	0.9998263889
pcrVenus	VenusDel	982	5760	1	5	6	0.0001736111	0.0008680556	0.0010416667	5759	0.9998263889
pcrVenus	VenusDel	983	5760	125	11	136	0.0217013889	0.0019097222	0.0236111111	5635	0.9782986111
pcrVenus	VenusDel	984	5760	0	0	0	0	0	0	5760	1
pcrVenus	VenusDel	985	5760	0	0	0	0	0	0	5760	1
pcrVenus	VenusDel	986	5760	1	0	1	0.0001736111	0	0.0001736111	5759	0.9998263889
pcrVenus	VenusDel	987	5760	5	2	7	0.0008680556	0.0003472222	0.0012152778	5755	0.9991319444
pcrVenus	VenusDel	988	5760	0	0	0	0	0	0	5760	1
pcrVenus	VenusDel	989	5760	0	2	2	0	0.0003472222	0.0003472222	5760	1
pcrVenus	VenusDel	990	5760	1	0	1	0.0001736111	0	0.0001736111	5759	0.9998263889
pcrVenus	VenusDel	991	5760	0	1	1	0	0.0001736111	0.0001736111	5760	1
pcrVenus	VenusDel	992	5760	0	0	0	0	0	0	5760	1
pcrVenus	VenusDel	993	5760	0	1	1	0	0.0001736111	0.0001736111	5760	1
pcrVenus	VenusDel	994	5760	0	2	2	0	0.0003472222	0.0003472222	5760	1
pcrVenus	VenusDel	995	5760	0	5	5	0	0.0008680556	0.0008680556	5760	1
pcrVenus	VenusDel	996	5760	1	0	1	0.0001736111	0	0.0001736111	5759	0.9998263889
pcrVenus	VenusDel	997	5760	0	2	2	0	0.0003472222	0.0003472222	5760	1
pcrVenus	VenusDel	998	5760	0	1	1	0	0.0001736111	0.0001736111	5760	1
pcrVenus	VenusDel	999	5760	1	1	2	0.0001736111	0.0001736111	0.0003472222	5759	0.9998263889
pcrVenus	VenusDel	1000	5760	2	4	6	0.0003472222	0.0006944444	0.0010416667	5758	0.9996527778
pcrVenus	VenusDel	1001	5760	0	0	0	0	0	0	5760	1
pcrVenus	VenusDel	1002	5760	0	0	0	0	0	0	5760	1
pcrVenus	VenusDel	1003	5760	0	0	0	0	0	0	5760	1
pcrVenus	VenusDel	1004	5760	2	6	8	0.0003472222	0.0010416667	0.0013888889	5758	0.9996527778
pcrVenus	VenusDel	1005	5760	0	0	0	0	0	0	5760	1
pcrVenus	VenusDel	1006	5760	0	0	0	0	0	0	5760	1
pcrVenus	VenusDel	1007	5760	0	1	1	0	0.0001736111	0.0001736111	5760	1
pcrVenus	VenusDel	1008	5760	2	0	2	0.0003472222	0	0.0003472222	5758	0.9996527778
pcrVenus	VenusDel	1009	5760	0	0	0	0	0	0	5760	1
pcrVenus	VenusDel	1010	5760	0	0	0	0	0	0	5760	1
pcrVenus	VenusDel	1011	5760	26	2	28	0.0045138889	0.0003472222	0.0048611111	5734	0.9954861111
pcrVenus	VenusDel	1012	5760	0	0	0	0	0	0	5760	1
pcrVenus	VenusDel	1013	5760	0	0	0	0	0	0	5760	1
pcrVenus	VenusDel	1014	5760	1	3	4	0.0001736111	0.0005208333	0.0006944444	5759	0.9998263889
pcrVenus	VenusDel	1015	5760	0	0	0	0	0	0	5760	1
pcrVenus	VenusDel	1016	5760	10	4	14	0.0017361111	0.0006944444	0.0024305556	5750	0.9982638889
pcrVenus	VenusDel	1017	5760	0	0	0	0	0	0	5760	1
pcrVenus	VenusDel	1018	5760	0	0	0	0	0	0	5760	1
pcrVenus	VenusDel	1019	5760	32	7	39	0.0055555556	0.0012152778	0.0067708333	5728	0.9944444444
pcrVenus	VenusDel	1020	5759	0	0	0	0	0	0	5759	1
pcrVenus	VenusDel	1021	5759	1	0	1	0.0001736413	0	0.0001736413	5758	0.9998263587
pcrVenus	VenusDel	1022	5759	1	0	1	0.0001736413	0	0.0001736413	5758	0.9998263587
pcrVenus	VenusDel	1023	5759	61	12	73	0.0105921167	0.0020836951	0.0126758118	5698	0.9894078833
pcrVenus	VenusDel	1024	5759	0	1	1	0	0.0001736413	0.0001736413	5759	1
pcrVenus	VenusDel	1025	5759	0	0	0	0	0	0	5759	1
pcrVenus	VenusDel	1026	5759	0	0	0	0	0	0	5759	1
pcrVenus	VenusDel	1027	5759	0	0	0	0	0	0	5759	1
pcrVenus	VenusDel	1028	5759	0	0	0	0	0	0	5759	1
pcrVenus	VenusDel	1029	5759	7	4	11	0.0012154888	0.000694565	0.0019100538	5752	0.9987845112
pcrVenus	VenusDel	1030	5759	0	0	0	0	0	0	5759	1
pcrVenus	VenusDel	1031	5759	0	2	2	0	0.0003472825	0.0003472825	5759	1
pcrVenus	VenusDel	1032	5759	0	6	6	0	0.0010418475	0.0010418475	5759	1
pcrVenus	VenusDel	1033	5759	4	4	8	0.000694565	0.000694565	0.0013891301	5755	0.999305435
pcrVenus	VenusDel	1034	5759	0	0	0	0	0	0	5759	1
pcrVenus	VenusDel	1035	5759	1	0	1	0.0001736413	0	0.0001736413	5758	0.9998263587
pcrVenus	VenusDel	1036	5759	1	1	2	0.0001736413	0.0001736413	0.0003472825	5758	0.9998263587
pcrVenus	VenusDel	1037	5758	2	7	9	0.0003473428	0.0012156999	0.0015630427	5756	0.9996526572
pcrVenus	VenusDel	1038	5757	3	0	3	0.0005211047	0	0.0005211047	5754	0.9994788953
pcrVenus	VenusDel	1039	5757	0	7	7	0	0.0012159111	0.0012159111	5757	1
pcrVenus	VenusDel	1040	5757	0	4	4	0	0.0006948063	0.0006948063	5757	1
pcrVenus	VenusDel	1041	5757	0	2	2	0	0.0003474032	0.0003474032	5757	1
pcrVenus	VenusDel	1042	5757	3	20	23	0.0005211047	0.0034740316	0.0039951364	5754	0.9994788953
pcrVenus	VenusDel	1043	5757	0	0	0	0	0	0	5757	1
pcrVenus	VenusDel	1044	5757	1	3	4	0.0001737016	0.0005211047	0.0006948063	5756	0.9998262984
pcrVenus	VenusDel	1045	5757	0	0	0	0	0	0	5757	1
pcrVenus	VenusDel	1046	5757	7	1	8	0.0012159111	0.0001737016	0.0013896126	5750	0.9987840889
pcrVenus	VenusDel	1047	5757	1	0	1	0.0001737016	0	0.0001737016	5756	0.9998262984
pcrVenus	VenusDel	1048	5757	349	44	393	0.0606218517	0.0076428696	0.0682647212	5408	0.9393781483
pcrVenus	VenusDel	1049	5757	1	0	1	0.0001737016	0	0.0001737016	5756	0.9998262984
pcrVenus	VenusDel	1050	5757	0	0	0	0	0	0	5757	1
pcrVenus	VenusDel	1051	5757	0	0	0	0	0	0	5757	1
pcrVenus	VenusDel	1052	5757	1	0	1	0.0001737016	0	0.0001737016	5756	0.9998262984
pcrVenus	VenusDel	1053	5757	1	0	1	0.0001737016	0	0.0001737016	5756	0.9998262984
pcrVenus	VenusDel	1054	5757	1	0	1	0.0001737016	0	0.0001737016	5756	0.9998262984
pcrVenus	VenusDel	1055	5757	0	1	1	0	0.0001737016	0.0001737016	5757	1
pcrVenus	VenusDel	1056	5757	0	2	2	0	0.0003474032	0.0003474032	5757	1
pcrVenus	VenusDel	1057	5757	1	2	3	0.0001737016	0.0003474032	0.0005211047	5756	0.9998262984
pcrVenus	VenusDel	1058	5757	2	0	2	0.0003474032	0	0.0003474032	5755	0.9996525968
pcrVenus	VenusDel	1059	5757	0	2	2	0	0.0003474032	0.0003474032	5757	1
pcrVenus	VenusDel	1060	5756	0	0	0	0	0	0	5756	1
pcrVenus	VenusDel	1061	5756	0	3	3	0	0.0005211953	0.0005211953	5756	1
pcrVenus	VenusDel	1062	5756	0	3	3	0	0.0005211953	0.0005211953	5756	1
pcrVenus	VenusDel	1063	5756	0	0	0	0	0	0	5756	1
pcrVenus	VenusDel	1064	5755	5	0	5	0.0008688097	0	0.0008688097	5750	0.9991311903
pcrVenus	VenusDel	1065	5755	0	0	0	0	0	0	5755	1
pcrVenus	VenusDel	1066	5755	0	1	1	0	0.0001737619	0.0001737619	5755	1
pcrVenus	VenusDel	1067	5755	13	4	17	0.0022589053	0.0006950478	0.0029539531	5742	0.9977410947
pcrVenus	VenusDel	1068	5755	2	0	2	0.0003475239	0	0.0003475239	5753	0.9996524761
pcrVenus	VenusDel	1069	5755	8	6	14	0.0013900956	0.0010425717	0.0024326672	5747	0.9986099044
pcrVenus	VenusDel	1070	5755	0	0	0	0	0	0	5755	1
pcrVenus	VenusDel	1071	5755	12	5	17	0.0020851434	0.0008688097	0.0029539531	5743	0.9979148566
pcrVenus	VenusDel	1072	5753	1	0	1	0.0001738224	0	0.0001738224	5752	0.9998261776
pcrVenus	VenusDel	1073	5753	3	1	4	0.0005214671	0.0001738224	0.0006952894	5750	0.9994785329
pcrVenus	VenusDel	1074	5753	7	0	7	0.0012167565	0	0.0012167565	5746	0.9987832435
pcrVenus	VenusDel	1075	5753	19	0	19	0.0033026247	0	0.0033026247	5734	0.9966973753
pcrVenus	VenusDel	1076	5750	17	2	19	0.0029565217	0.0003478261	0.0033043478	5733	0.9970434783
pcrVenus	VenusDel	1077	5749	8	6	14	0.0013915464	0.0010436598	0.0024352061	5741	0.9986084536
pcrVenus	VenusDel	1078	5747	1	1	2	0.0001740038	0.0001740038	0.0003480077	5746	0.9998259962
pcrVenus	VenusDel	1079	5742	0	0	0	0	0	0	5742	1
pcrVenus	VenusDel	1080	5732	0	0	0	0	0	0	5732	1
pcrVenus	VenusDel	1081	5407	0	14	14	0	0.0025892362	0.0025892362	5407	1
